artig	ειδής
bar	ιμος
er	έζος
förmig	ειδής
graphie	γραφία
hältig	ούχος
id	ειδής
in	ιδα
isch	ικός
ismus	ισμός
itis	ίτιδα
keit	ότητα
manie	μανία
mantie	ματία
oid	ειδής
ose	όζη
phil	φιλος
skop	σκόπιο
stat	στάτης
Aa machen	κάνω κακά
Aachen	Άαχεν
Aal	χέλι
Aalborg	Άλμποργκ
Aaron	Ααρών
Aas	ψοφίμι
Abaka	αβάκα
Abakus	άβακας
Abaton	άβατο
Abberufung	ανάκληση
Abbestellung	ακύρωση παραγγελίας
Abbild	απεικόνιση
Abblendlicht	μεσαίος
Abchasien	Αμπχαζία
Abderit	αβδηρίτης
Abdominalgravidität	εξωμήτριος κύηση
Abdruck	αποτύπωμα
Abduktion	απαγωγή
Abduktor	απαγωγός μυς
Abel	Άβελ
Abend	βράδυ
Abendbrot	βραδινό
Abenddämmerung	βράδιασμα
Abendessen	δείπνο
Abendgebet	εσπερινός
Abendkleid	βραδινό φόρεμα
Abendmahl	Μυστικός Δείπνος
Abendsonne	απογευματινός ήλιος
Abens	Άμπενς
Abenteuer	περιπέτεια
Aberglaube	δεισιδαιμονία
Abfahrt	αναχώρηση
Abfluss	σιφόνι
Abführmittel	καθαρτικό
Abgas	καυσαέρια
Abgeordneter	βουλευτής
Abgott	ίνδαλμα
Abgrund	άβυσσος
Abhang	πλαγιά
Abhängigkeit	εξάρτηση
Abigail	Αβιγαία
Abitur	απολυτήριο
Abkommen	συμφωνία
Abkömmling	απόγονος
Abkürzung	παράκαμψη
Ablassbrief	συγχωροχάρτι
Ablativ	αφαιρετική
Ableitung	παράγωγο
Ablenkung	διάθλαση
Abluft	εξαχθείς αέρας
Abluftkanal	αγωγός μολυσμένου αέρα
Abnehmer	αγοραστής
Abneigung	αντιπάθεια
Abonnement	συνδρομή
Abonnent	συνδρομητής
Abraham	Αβραάμ
Abreise	αναχώρηση
Abrüstung	αφοπλισμός
Absatz	παράγραφος
Abschaffung	κατάργηση
Abschnitt	εδάφιο
Abseits	περιθώριο
Absicht	πρόθεση
Absinth	αψέντι
Absolutismus	απολυταρχία
Absonderung	απομόνωση
Abstand	απόσταση
Abstimmung	ψηφοφορία
Abstinenz	εγκράτεια
Abszess	απόστημα
Abt	ηγούμενος
Abtei	αβαείο
Abteil	κουπέ
Abtreibung	έκτρωση
Abu Dhabi	Άμπου Ντάμπι
Abwasch	πλύσιμο
Abwasser	λύματα
Abwasserkanal	αποχετευτικός σωλήνας
Abweichung	εξαίρεση
Abyssus	άβυσσος
Abzug	σκανδάλη
Acetylsalicylsäure	ακετυλοσαλικυλικό οξύ
Achat	αχάτης
Achilles	Αχιλλέας
Achillesferse	Αχίλλειος πτέρνα
Achillessehne	Αχίλλειος τένοντας
Achilleus	Αχιλλέας
Achondroplasie	αχονδροπλασία
Achse	άξονας
Achsel	μασχάλη
Achselhöhle	μασχάλη
Achteck	οκτάγωνο
Achterbahn	τρενάκι του τρόμου
Achtung	σεβασμός
Acker	αγρός
Actinium	aκτίνιο
Actionkamera	action camera
Adam	Αδάμ
Adamsapfel	μήλο του Αδάμ
Addis Abeba	Αντίς Αμπέμπα
Addition	πρόσθεση
Adelaide	Αδελαΐδα
Adelheid	Αδελαΐδα
Adenin	αδενίνη
Adenosintriphosphat	τριφωσφορική αδενοσίνη
Ader	φλέβα
Aderlass	φλεβοτομία
Adjektiv	επίθετο
Adler	αετός
Admiral	ναύαρχος
Adolf	Αδόλφος
Adonis	Άδωνις
Adoption	υιοθεσία
Adrenalin	αδρεναλίνη
Adresse	διεύθυνση
Adrianopel	Αδριανούπολις
Adriatisches Meer	Αδριατική θάλασσα
Adschman	Ατζμάν
Adsorption	προσρόφηση
Adverb	επίρρημα
Aerodrom	αεροδρόμιο
Aerodynamik	αεροδυναμική
Affe	πίθηκος
Affinität	συγγένεια
Affix	προσθήκη
Afghanistan	Αφγανιστάν
Afrika	Αφρική
Afrika-Eurasien	Ευρασία-Αφρική
Afrikaans	Αφρικάνικα
Afrikaner	Αφρικανός
Afrikanische Union	Αφρικανική Ένωση
After	πρωκτός
Agadir	Αγκαντίρ
Agamemnon	Αγαμέμνονας
Agathe	Αγάθη
Agave	αγαύη
Agent	πράκτορας
Agentur	πρακτορείο
Aggression	επίθεση
Aggressivität	επιθετικότητα
Agnes	Αγνή
Agnosie	αγνωσία
Agnostizismus	αγνωστικισμός
Agonie	χαροπάλεμα
Agora	αγορά
Agoraphobie	αγοραφοβία
Agrarbetrieb	αγροτική επιχείρηση
Ahn	πρόγονος
Ahorn	σφενδάμι
Aids	έιτζ
Aikido	αϊκίντο
Airbag	αερόσακος
Airbrush	μικροψεκαστήρας
Ajax	Αίας
Akaba	Άκαμπα
Akademie	ακαδημία
Akazie	ακακία
Akkordeon	ακορντεόν
Akkusativ	αιτιατική
Akne	ακμή
Akrobat	ακροβάτης
Akropolis	Ακρόπολη
Akrostichon	ακροστιχίδα
Akt	πράξη
Akte	φάκελος
Aktie	μετοχή
Aktiengesellschaft	ανώνυμη εταιρία
Aktionsart	ποιόν
Aktionär	μέτοχος
Aktiv	ενεργητική φωνή
Aktivität	δραστηριότητα
Aktivum	ενεργητική φωνή
Akupunktur	βελονισμός
Akustik	ακουστική
Akzeptanz	αποδοχή
Alabama	Αλαμπάμα
Alabaster	αλάβαστρο
Aladin	Αλαντίν
Aland	Άλαντ
Alanin	αλανίνη
Alarm	συναγερμός
Alarmismus	κινδυνολογία
Alaska	Αλάσκα
Alaska-Seelachs	potamolávrako
Albanien	Αλβανία
Albanisch	Αλβανικά
Albatros	άλμπατρος
Albe	στιχάριο
Albert	Άλβέρτος
Albinismus	αλφισμός
Albtraum	εφιάλτης
Album	άλμπουμ
Albumin	λευκωματίνη
Alchemie	αλχημεία
Aldehyd	αλδεΰδη
Aleppokiefer	κοινό πεύκο
Alex	Αλεξ
Alexander	Αλέξανδρος
Alexandra	Αλεξάνδρα
Alexithymie	αλεξιθυμία
Alfons	Αλφόνσος
Alfred	Αλφρέδος
Algarve	Αλγκάρβε
Alge	φύκος
Algebra	άλγεβρα
Algerien	Αλγερία
Algerier	Αλγερινός
Algerierin	Αλγερινή
Algier	Αλγέρι
Algorithmus	αλγόριθμος
Alibi	άλλοθι
Alkaloid	αλκαλοειδές
Alkan	αλκάνιο
Alkohol	οινόπνευμα
Alkoholiker	αλκοολικός
Alkoholismus	αλκοολισμός
Allah	Αλλάχ
Allee	λεωφόρος
Allegorie	αλληγορία
Allergie	αλλεργία
Allheilmittel	πανάκεια
Allianz	συμμαχία
Alligator	αλιγάτορας
Allotropie	αλλοτροπία
Alltag	καθημερινότητα
Alltagskleidung	καθημερινός
Almanach	αλμανάκ
Almosen	ελεημοσύνη
Alpen	Άλπεις
Alpendohle	κιτρινοκαλιακούδα
Alpha	άλφα
Alphabet	αλφάβητο
Alraune	μανδραγόρας
Altar	βωμός
Altenglisch	Αρχαία αγγλική γλώσσα
Altenheim	οίκος ευγηρίας
Alter	γέρος
Alter	ηλικία
Alternative	εναλλακτικός
Altersheim	οίκος ευγηρίας
Altertum	αρχαιότητα
Altes Testament	Παλαιά Διαθήκη
Altfranzösisch	αρχαία γαλλική
Altgriechisch	αρχαία ελληνικά
Altruismus	αλτρουισμός
Altruist	αλτρουιστής
Altweibersommer	ινδιάνικο καλοκαίρι
Aluminium	αλουμίνιο
Amalfi	Αμάλφι
Amalgam	αμάλγαμα
Amazonas	Αμαζόνιος
Amazone	Αμαζόνα
Amboss	αμόνι
Ameise	μυρμήγκι
Ameisenbär	μυρμηγκοφάγος
Ameisenhaufen	μυρμηγκοφωλιά
Ameisensäure	μυρμηκικός
Amen	αμήν
American Football	αμερικανικό ποδόσφαιρο
Americium	αμερίκιο
Amerika	Αμερική
Amethyst	αμέθυστος
Aminosäure	αμινοξύ
Amman	Αμμάν
Amme	τροφός
Ammoniak	αμμωνία
Ammonium	αμμώνιο
Amnestie	αμνηστία
Ampel	φανάρια
Ampere	αμπέρ
Amperemeter	αμπερόμετρο
Ampfer	λάπατο
Amphetamin	αμφεταμίνη
Amphibie	αμφίβιο
Amphitheater	αμφιθέατρο
Amphore	αμφορέας
Ampulle	αμπούλα
Amputation	ακρωτηριασμός
Amsel	κότσυφας
Amsterdam	Άμστερνταμ
Amtsperiode	υπηρεσιακός
Amtsschimmel	γραφειοκρατία
Amulett	φυλαχτό
Amylum	άμυλο
Amöbe	αμοιβάδα
Anachoret	αναχωρητής
Anagnorisis	αναγνώρισις
Anagramm	αναγραμματισμός
Analogie	αναλογία
Analphabet	αναλφάβητος
Analverkehr	πρωκτική συνουσία
Analyse	ανάλυση
Analysis	μαθηματική ανάλυση
Anamnese	ιστορικό
Ananas	ανανάς
Anarchie	αναρχία
Anarchismus	αναρχισμός
Anatom	ανατόμος
Anatomie	ανατομία
Anbau	καλλιέργεια
Anbieter	παροχέας
Andalusien	Ανδαλουσία
Andamanen	Ανταμάν
Anden	Άνδεις
Andorra	Ανδόρα
Andreas	Ανδρέας
Androgen	ανδρογόνο
Andrologie	ανδρολογία
Andromeda	Ανδρομέδα
Anekdote	ανέκδοτο
Anemone	ανεμώνα
Anerbieten	πρόταση
Aneurysma	ανεύρυσμα
Anfang	αρχή
Anfänger	αρχάριος
Anführungszeichen	εισαγωγικά
Angabe	πληροφορία
Angebot	προσφορά
Angehöriger	μέλος
Angeklagte	κατηγορούμενη
Angeklagter	κατηγορούμενος
Angel	καλάμι
Angelhaken	αγκίστρι
Angelika	Αγγελική
Angelologie	αγγελολογία
Angelrute	καλάμι ψαρέματος
Angestellter	υπάλληλος
Angewohnheit	συνήθεια
Angler	ψαράς
Anglizismus	αγγλισμός
Angola	Ανγκόλα
Angreifer	επιτιθέμενος
Angriff	επίθεση
Angst	άγχος
Angst und Schrecken	φόβος και τρόμος
Anguilla	Ανγκουίλα
Anhänger	ρυμούλκα
Anilin	ανιλίνη
Anime	άνιμε
Animismus	ανιμισμός
Anion	ανιόν
Anis	γλυκάνισο
Ankara	Άγκυρα
Anker	άγκυρα
Ankunft	άφιξη
Anleitung	οδηγία
Annexion	προσάρτηση
Annihilation	αφανισμόσ
Annäherung	προσέγγιση
Anode	άνοδος
Anomalie	ανωμαλία
Anonymität	ανωνυμία
Anorak	άνορακ
Anorexie	ανορεξία
Anosmie	ανοσμία
Anrufbeantworter	τηλεφωνητής
Anrufung	επίκληση
Anschrift	διεύθυνση
Ansichtskarte	κάρτα
Anspannung	ένταση
Anspielung	υπαινιγμός
Anstalt	ίδρυμα
Anstrengung	κούραση
Antagonist	ανταγωνιστής
Antarktis	Ανταρκτική
Antenne	κεραία
Anthropologie	ανθρωπολογία
Anthropomorphismus	ανθρωπομορφισμός
Anthropophagie	ανθρωποφαγία
Antibiotikum	αντιβιοτικό
Antichrist	Αντίχριστος
Antidepressivum	αντικαταθλιπτικό
Antigen	αντιγόνο
Antigua und Barbuda	Αντίγκουα και Μπαρμπούντα
Antiheld	αντιήρωας
Antike	αρχαιότητα
Antikörper	αντίσωμα
Antillen	Αντίλλες
Antilope	αντιλόπη
Antimaterie	αντιύλη
Antimon	αντιμόνιο
Antioxidans	αντιοξειδωτικό
Antipode	αντίποδας
Antiquität	αντίκα
Antisemit	αντισημίτης
Antisemitismus	αντισημιτισμός
Anton	Αντώνιος
Antonomasie	αντονομασία
Antonym	αντώνυμο
Antwerpen	Αμβέρσα
Antwort	απάντηση
Anus	πρωκτός
Anwalt	δικηγόρος
Anweisung	εντολή
Anwesenheit	παρουσία
Anzahl	αριθμός
Anzug	κοστούμι
Anästhesie	αναισθησία
Anästhesiologie	αναισθησιολογία
Aorist	αόριστος
Aorta	αορτή
Aosta	Αόστα
Apartheid	πολιτική φυλετικού διαχωρισμού
Apartheidpolitik	πολιτική του απαρτχάιντ
Apathie	απάθεια
Apatit	απατίτης
Apennin	Απέννινα
Apenninen	Απέννινα
Aperitif	απεριτίφ
Apfel	μήλο
Apfelbaum	μηλιά
Apfelkuchen	μηλόπιτα
Apfelmus	πολτός
Apfelsaft	χυμός μήλου
Apfelsaftschorle	χυμός μήλου με ανθρακούχο νερό
Apfelschorle	χυμός μήλου με ανθρακούχο νερό
Apfelsine	πορτοκάλι
Aphasie	αφασία
Aphorismus	απόφθεγμα
Aphrodite	Αφροδίτη
Aphthe	άφθα
Apokalypse	αποκάλυψη
Apokope	αποκοπή
Apologie	απολογία
Apophthegma	απόφθεγμα
Apostel	απόστολος
Apostelgeschichte	Πράξεις των Αποστόλων
Apostroph	απόστροφος
Apotheke	φαρμακείο
Apotheker	φαρμακοποιός
Apotheose	απoθεωσις
Apparat	συσκευή
Appell	έκκληση
Appetit	όρεξη
Appetitlosigkeit	ανορεξία
Applaus	χειροκρότημα
Aprikose	βερικοκιά
Aprilscherz	πρωταπριλιά
Apulien	Απουλία
Apökie	αποικία
Aquamarin	ακουαμαρίνα
Aquaplaning	υδρολίσθηση
Aquarium	ενυδρείο
Aquitanien	Ακουιτανία
Aquädukt	υδραγωγείο
Ara	μακάο
Arabien	Αραβία
Arabisch	Αραβικά
Arabische Republik Ägypten	Αραβική Δημοκρατία της Αιγύπτου
Arabist	αραβιστής
Arachnophobie	αραχνοφοβία
Aragon	Αραγονία
Aragonien	Αραγονία
Aramäisch	Αραμαϊκή
Arbeit	εργασία
Arbeiter	εργάτης
Arbeiterin	εργάτρια
Arbeitgeber	εργοδότης
Arbeitnehmer	εργαζόμενος
Arbeitsamt	γραφείο εύρεσης εργασίας
Arbeitsbiene	εργάτρια
Arbeitslosigkeit	ανεργία
Arbeitsstunde	εργατοώρα
Arbeitswoche	εργάσιμη εβδομάδα
Arbeitszeit	ωράριο
Archaismus	αρχαϊσμός
Archangelsk	Αρχάγγελσκ
Archimedes	Αρχιμήδης
Archipel	αρχιπέλαγος
Architekt	αρχιτέκτονας
Architektin	αρχιτεκτόνισσα
Architektur	αρχιτεκτονική
Archiv	αρχείο
Archäologe	αρχαιολόγος
Archäologie	αρχαιολογία
Arena	αρένα
Argentinien	Αργεντινή
Argentinier	Αργεντινός
Argentinische Republik	Αργεντινή Δημοκρατία
Arginin	αργινίνη
Argon	αργό
Argument	επιχείρημα
Argus	Άργος
Ariadne	Αριάδνη
Arie	άρια
Aristokratie	αριστοκρατία
Aristoteles	Αριστοτέλης
Arizona	Αριζόνα
Arkadien	Αρκαδία
Arkansas	Αρκάνσας
Arktis	Αρκτική
Armada	αρμάδα
Armband	βραχιόλι
Armbeuge	αγκώνας
Armbrust	βαλλίστρα
Armee	στρατός
Armenien	Αρμενία
Armenisch	αρμενικά
Armut	φτώχια
Armutsschwelle	όριο φτώχιας
Aroma	άρωμα
Aromunisch	Κουκοβλάσκι
Arsch	κώλος
Arschloch	κωλοτρυπίδα
Arsen	αρσενικό
Art	είδος
Artemis	Άρτεμις
Arterie	αρτηρία
Arthropoda	αρθρόποδα
Arthropode	αρθρόποδο
Arthur	Αρθούρος
Artikel	είδος
Artillerist	πυροβολητής
Artischocke	αγκινάρα
Aruba	Αρούμπα
Arvanitika	αρβανίτικα
Arznei	φάρμακο
Arzneimittel	φάρμακο
Arzneipflanze	φυτό
Arzt	γιατρός
Asbest	αμίαντος
Aschaffenburg	Ασάφενμπουργκ
Asche	στάχτη
Aschenbecher	σταχτοδοχείο
Aschenputtel	Σταχτοπούτα
Ascona	Ασκόνα
Asebie	ασέβεια
Aserbaidschan	Αζερμπαϊτζάν
Aserbaidschanisch	Αζερικά
Asien	Ασία
Asmara	Ασμάρα
Aspekt	άποψη
Asphalt	άσφαλτος
Asphyxie	ασφυξία
Ass	άσος
Assimilation	αφομοίωση
Assisi	Ασίζη
Assistent	βοηθός
Assyrien	Ασσυρία
Ast	κλάδος
Astat	άστατο
Aster	αστέρας
Asterisk	αστερίσκος
Asterix	Αστερίξ
Asteroid	αστεροειδής
Asthenosphäre	ασθενόσφαιρα
Asthma	άσθμα
Astrologe	αστρολόγος
Astrologie	αστρολογία
Astronaut	αστροναύτης
Astronom	αστρονόμος
Astronomie	αστρονομία
Astronomische Einheit	Αστρονομική μονάδα
Astrophysik	αστροφυσική
Asturien	Αστούριες
Asyl	άσυλο
Asymptote	ασύμπτωτη
Atem	αναπνοή
Athanasius	Αθανάσιος
Atheismus	αθεϊσμός
Atheist	άθεος
Athen	Αθήνα
Athene	Αθηνά
Athlet	αθλητής
Athos	Άθως
Atlantik	Ατλαντικός
Atlantis	Ατλαντίδα
Atlantischer Ozean	Ατλαντικός Ωκεανός
Atlas	άτλαντας
Atmosphäre	ατμόσφαιρα
Atmung	αναπνοή
Atoll	ατθηλυκό
Atom	άτομο
Atombindung	δεσμός
Atombombe	ατομική βόμβα
Atomkraft	πυρηνικός
Atomstrom	ρεύμα από πυρηνικό σταθμό
Atomuhr	ατομικό ρολόι
Atomwaffe	πυρηνικό όπλο
Atonie	ατονία
Atresie	ατρησία
Atrium	αίθριο
Atrophie	ατροφία
Atropin	ατροπίνη
Attacke	επίθεση
Attentat	δολοφονία
Attentäter	δράστης
Attika	Αττική
Aubergine	μελιτζάνα
Aue	ποταμιά
Auerhuhn	αγριόκουρκος
Aufenthalt	διαμονή
Auferstehung	ανάσταση
Aufgabe	εργασία
Aufgebot	γνωστοποίηση
Aufschub	αναβολή
Aufstand	εξέγερση
Aufstieg	άνοδος
Aufstrich	άλειμμα
Auftrag	εντολή
Auftreten	συμπεριφορά
Auftritt	εμφάνιση
Aufzug	ασανσέρ
Auge	μάτι
Auge um Auge, Zahn um Zahn	οφθαλμόν αντί οφθαλμού και οδόντα αντί οδόντος
Augenarzt	οφθαλμίατρος
Augenblick	στιγμή
Augenbraue	φρύδι
Augenhöhle	οφθαλμικός κόγχος
Augenklappe	καλύπτρα ματιού
Augenklinik	οφθαλμιατρείο
Augenlid	βλέφαρον
Augenzeuge	αυτόπτης μάρτυρας
Augiasstall	κόπρος
Augment	αύξηση
Augmentativ	μεγεθυντικό
Augsburg	Άουγκσμπουργκ
Auktion	πλειστηριασμός
Aura	αύρα
Ausbeutung	εκμετάλλευση
Ausbilder	εκπαιδευτής
Ausbildung	εκπαίδευση
Auschwitz	Οσβιέτσιμ
Ausdauer	αντοχή
Ausdehnung	έκταση
Ausdrucksweise	τρόπος
Ausflug	εκδρομή
Ausgabe	διανομή
Ausgang	εξόδος
Ausgangssperre	απαγόρευση της κυκλοφορίας
Ausgrabung	ανασκαφή
Ausland	εξωτερικό
Auslassungspunkte	αποσιωπητικά
Auslieferung	έκδοση
Ausländer	ξένος
Ausnahme	εξαίρεση
Ausnahmezustand	κατάσταση έκτακτης ανάγκης
Ausnutzung	εκμετάλλευση
Ausrufezeichen	θαυμαστικό
Ausrüstung	εξοπλισμός
Aussage	δήλωση
Aussageverweigerung	άρνηση
Ausschalten	σβήσιμο
Ausscheidung	έκκριση
Ausschreitung	έκτροπα
Ausschuss	επιτροπή
Aussehen	όψη
Aussicht	θέα
Aussprache	προφορά
Ausstellung	έκθεση
Aussterben	εξαφάνιση
Auster	στρείδι
Austerität	αυστηρότητα
Australasien	Αυστραλασία
Australien	Αυστραλία
Auswanderer	μετανάστης
Ausweglosigkeit	αδιέξοδο
Ausweis	ταυτότητα
Auszeit	τάιμ άουτ
Auszubildender	μαθητευόμενος
Autarkie	αυτάρκεια
Authentizität	αυθεντικότητα
Autismus	αυτισμός
Auto	αυτοκίνητο
Autobahn	αυτοκινητόδρομος
Autobiografie	αυτοβιογραφία
Autobus	λεωφορείο
Autofahren	οδήγηση
Autofahrer	οδηγός αυτοκινήτου
Autogramm	αυτόγραφο
Autokino	κινηματογράφος αυτοκινήτων
Automat	αυτόματο
Automobil	αυτοκίνητο
Autor	δημιουργός
Autorität	κύρος
Autowaschanlage	πλυντήριο αυτοκινήτων
Außenluft	καθαρός αέρας
Außenminister	υπουργός εξωτερικών
Außenpolitik	εξωτερική πολιτική
Außerirdischer	εξωγήινος
Aversion	αντιπάθεια
Avignon	Αβινιόν
Avitaminose	αβιταμίνωση
Avocado	αβοκάντο
Axiologie	αξιολογία
Axon	άξων
Axt	τσεκούρι
Azalee	αζαλέα
Azeton	ακετόνη
Azimut	αζιμούθιο
Azoren	Αζόρες
Azubi	μαθητευομένη
Azubi	μαθητευόμενος
Azurit	αζουρίτης
Baby	μωρό
Babylon	Βαβυλώνα
Bach	ρυάκι
Backblech	ταψί
Backbord	αριστέρη πλευρά
Backenzahn	τραπεζίτης
Backgammon	τάβλι
Backpapier	λαδόκολλα
Backpflaume	ξηρό δαμάσκηνο
Backpulver	μπέικιν πάουντερ
Backstein	τούβλο
Bad	μπάνιο
Badajoz	Μπαδαχόθ
Badeanzug	μαγιό
Baden-Baden	Μπάντεν-Μπάντεν
Baden-Württemberg	Βάδη-Βυρτεμβέργη
Badetuch	πετσέτα
Badewanne	μπανιέρα
Badezimmer	μπάνιο
Badminton	αντιπτέριση
Bagdad	Βαγδάτη
Bagel	κουλούρι
Bagger	εκσκαφέας
Baguette	μπαγκέτα
Bahamas	Μπαχάμες
Bahn	δρόμος
Bahnhof	σταθμός
Bahnsteig	πλατφόρμα
Bahrain	Μπαχρέιν
Baikal	Βαϊκάλη
Baikal	Βαϊκάλη
Baikalsee	Βαϊκάλη
Bajonett	ξιφολόγχη
Bakelit	βακελίτης
Bakterie	βακτηρίδιο
Bakteriologie	βακτηριολογία
Bakteriophage	βακτηριοφάγος
Balalaika	μπαλαλάικα
Balanitis	βαλανίτις
Balkan	Βαλκάνια
Balken	δοκάρι
Balkon	μπαλκόνι
Ball	μπάλα
Ballaststoff	φυτικές ίνες
Ballett	μπαλέτο
Ballistik	βλητική
Balsam	βάλσαμο
Bambus	μπαμπού
Banane	μπανάνα
Bananenrepublik	μπανανία
Band	συγκρότημα
Band	τόμος
Band	κορδέλα
Bandoneon	μπαντονεόν
Bandwurm	ταινία
Bangkok	Μπανγκόκ
Bangladesch	Μπανγκλαντές
Banjo	μπάντζο
Banjul	Μπανζούλ
Bank	πάγκος
Bankangestellter	υπάλληλος
Bankett	επίσημος
Bankraub	ληστεία
Bankrott	πτώχευση
Bar	μπαρ
Bar	μπαρ
Barbados	Μπαρμπάντος
Barcelona	Βαρκελώνη
Barde	βάρδος
Barentssee	Θάλασσα Μπάρεντς
Bargeld	μετρητά
Barium	βάριο
Bark	βάρκα
Barock	μπαρόκ
Barometer	βαρόμετρο
Barsch	πέρκα
Bart	γένι
Bartholomäus	Βαρθολομαίος
Basalt	βασάλτης
Base	βάση
Baseball	μπέιζμπολ
Basel	Βασιλεία
Basilika	βασιλική
Basilikum	βασιλικός
Baskenland	Χώρα των Βάσκων
Basketball	καλαθοσφαίριση
Baskisch	Βασκικά
Bastard	μπάσταρδος
Batate	γλυκοπατάτα
Batterie	μπαταρία
Bau	κατασκευή
Bauarbeiter	οικοδόμος
Bauch	κοιλιά
Bauchredner	εγγαστρίμυθος
Bauchspeicheldrüse	πάγκρεας
Bauer	αγρότης
Bauernhof	αγρόκτημα
Baugenehmigung	άδεια
Baugerüst	σκαλωσιά
Baum	δέντρο
Baumgruppe	συστάδα
Baumwolle	βαμβάκι
Baumwollpflanze	βαμβακιά
Baumwollplantage	βαμβακοφυτεία
Baumwollspinnerei	βαμβακοκλωστήριο
Bauordnung	ΓΟΚ
Bauplan	κατασκευή
Baustelle	εργοτάξιο
Baustopp	σταμάτημα
Bauunternehmer	οικοδομή
Bauvorhaben	οικοδόμηση
Bauxit	βωξίτης
Bayern	Βαυαρία
Bayreuth	Μπαϊρόιτ
Beamter	δημόσιος υπάλληλος
Beamtin	υπάλληλος
Beben	σεισμός
Becher	κούπα
Becken	λεκάνη
Bedeckung	κάλυψη
Bedeutung	σημασία
Bedeutungslosigkeit	ασημαντότητα
Bedeutungswandel	σημασιολογικής μεταβολής
Bedienungsanleitung	οδηγία
Bedrohung	απειλή
Beerdigung	κηδεία
Beere	μούρο
Beet	παρτέρι
Befall	μόλυνση
Befruchtung	γονιμοποίηση
Begeisterung	ενθουσιασμός
Beginn	αρχή
Behaarung	τρίχωμα
Behaviorismus	συμπεριφορισμός
Behälter	δοχείο
Behörde	αρχή
Beichte	εξομολόγηση
Beichtstuhl	εξομολογητήριο
Beifall	χειροκρότημα
Beileid	συλλυπητήρια
Bein	πόδι
Beinbruch	κάταγμα
Beirut	Βηρυτός
Beispiel	παράδειγμα
Bekannter	γνωστός
Bekanntheit	διασημότητα
Bekanntmachung	ανακοίνωση
Bekanntschaft	γνωριμία
Bekleidung	ρούχα
Belagerung	πολιορκία
Beleidigung	προσβολή
Belfast	Μπέλφαστ
Belgien	Βέλγιο
Belgier	Βέλγος
Belgierin	Βελγίδα
Belgrad	Βελιγράδι
Belize	Μπελίζε
Bellizist	πολεμοκάπηλος
Belohnung	ανταμοιβή
Belästigung	παρενόχληση
Belüftung	αερισμός
Bemühung	προσπάθεια
Benedikt	Βενέδικτος
Benin	Μπενίν
Benthos	βένθος
Benutzer	χρήστης
Benutzung	χρήση
Benzin	βενζίνη
Benzol	βενζόλιο
Beobachtung	παρατήρηση
Berberitze	βερβερίδα
Berchtesgaden	Μπέρχτεσγκαντεν
Berg	βουνό
Bergahorn	σφένδαμος ψευδοπλάτανος
Bergbau	εξόρυξη
Bergfink	χειμωνόσπινος
Berghang	βουνοπλαγιά
Bergkarabach	Ναγκόρνο-Καραμπάχ
Bergkette	οροσειρά
Bergkristall	ορεία κρύσταλλος
Bergrücken	ράχη
Bergsteigen	ορειβασία
Bergsteiger	ορειβάτης
Bergsteigerin	ορειβάτισσα
Bergwerk	ορυχείο
Berichterstatter	ανταποκριτής
Berichterstatterin	ανταποκρίτρια
Berichterstattung	ανταπόκριση
Berkelium	μπερκελιο
Berlin	Βερολίνο
Berliner Mauer	Τείχος του Βερολίνου
Bermuda	Βερμούδες
Bern	Βέρνη
Bernstein	κεχριμπάρι
Beruf	επάγγελμα
Beruhigung	εξομάλυνση
Beruhigungsmittel	ηρεμιστικό
Beryllium	βηρύλλιο
Besatz	φάσα
Besatzung	πλήρωμα
Bescheid	ειδοποίηση
Beschleunigung	επιτάχυνση
Beschneidung	περιτομή
Beschränkung	περιορισμός
Beschuldigter	κατηγορούμενος
Beschwerde	παράπονο
Beschäftigter	απασχολούμενος
Besen	σκούπα
Besessenheit	δαιμονιοπληξία
Besetzung	διανομή
Besiedelung	αποικισμός
Besitz	κατοχή
Besitzer	νομέας
Bessarabien	Βεσσαραβία
Besserwisser	εξυπνάκιας
Bestattung	κηδεία
Bestechung	δωροδοκία
Besteck	μαχαιροπίρουνο
Bestrafung	τιμωρία
Bestseller	μπεστ σέλερ
Besuch	επίσκεψη
Beta	βήτα
Beteigeuze	Μπετελγκέζ
Bethlehem	Βηθλεέμ
Beton	σκυρόδεμα
Betonung	τονισμός
Betreuung	φροντίδα
Betriebssystem	λειτουργικό σύστημα
Betrug	απάτη
Betrübnis	θλίψη
Betrüger	απατεώνας
Bett	κρεβάτι
Bettlaken	σεντόνι
Bettler	ζητιάνος
Bettzeug	σεντόνια
Beunruhigung	ανησυχία
Beute	λεία
Bevölkerung	πληθυσμός
Bewegung	κίνηση
Bewirtschaftung	διαχείριση
Bewohner	κάτοικος
Bewohnerin	κάτοικος
Bewunderung	θαυμασμός
Bewusstlosigkeit	λιποθυμία
Bewusstsein	συνείδηση
Bezahlung	αμοιβή
Bezeichnung	ονομασία
Beziehung	σχέση
Bhagavadgita	Μπαγκαβάτ Γκίτα
Bhutan	Μπουτάν
Biathlon	δίαθλο
Bibel	Βίβλος
Biber	κάστορας
Bibliografie	βιβλιογραφία
Bibliothek	βιβλιοθήκη
Bibliothekar	βιβλιοθηκάριος
Bidet	μπιντές
Bielefeld	Μπίλεφελντ
Biene	μέλισσα
Bienenfresser	μελισσοφάγος
Bienenkönigin	μέλισσα
Bienenstock	κυψέλη
Biennale	μπιενάλε
Bier	ζύθος
Bigamie	διγαμία
Bikini	μπικίνι
Bilanz	ισολογισμός
Bild	εικόνα
Bildhauer	γλύπτης
Bildung	ίδρυση
Billard	μπιλιάρδο
Bims	ελαφρόπετρα
Bimsstein	ελαφρόπετρα
Bindegewebe	συνδετικός ιστός
Bindestrich	ενωτικό
Biochemie	βιοχημεία
Biodiversität	βιοποικιλότητα
Biografie	βιογραφία
Biologe	βιολόγος
Biologie	βιολογία
Biophysik	βιοφυσική
Biosphäre	βιόσφαιρα
Birke	σημύδα
Birkhuhn	λυροπετεινός
Birma	Βιρμανία
Birnbaum	αχλαδιά
Birne	αχλαδιά
Bisamratte	μοσχοπόντικας
Bischkek	Μπισκέκ
Bischof	επίσκοπος
Biss	δάγκωμα
Bistum	επισκοπή
Bit	δυφίο
Bitcoin	μπίτκοϊν
Bitte	παράκληση
Bitterkeit	πίκρα
Bitternis	πικρία
Bitumen	βιτουμένιο
Bizeps	δικέφαλος
Blase	κύστη
Blasinstrument	πνευστό όργανο
Blasius	Βλάσιος
Blasphemie	βλασφημία
Blatt	φύλλο
Blattlaus	αφίδα
Blattsalat	πράσινη σαλάτα
Blau	μπλε
Blaubeere	μύρτιλλο
Blaupause	κυανοτυπία
Blausäure	υδροκυανικό οξύ
Blauwal	γαλάζια φάλαινα
Blech	λαμαρίνα
Blei	μόλυβδος
Bleistift	μολύβι
Blepharitis	βλεφαρίτιδα
Bleuel	κόπανος
Blick	βλέμμα
Blinddarm	τυφλό έντερο
Blindekuh	τυφλόμυγα
Blindenhund	σκυλί για τυφλούς
Blindheit	τύφλωση
Blitz	κεραυνός
Blitzableiter	αλεξικέραυνο
Blockflöte	φλάουτο
Blog	ιστολόγιο
Blume	λουλούδι
Blumenkohl	κουνουπίδι
Blumenladen	ανθοπωλείο
Blumenstrauß	ανθοδέσμη
Blumentopf	γλάστρα
Blumenvase	ανθοδοχείο
Bluse	μπλούζα
Blut	αίμα
Blutarmut	αναιμία
Blutbad	αιματοκύλισμα
Blutbild	αιματολογική
Blutdruck	πίεση του αίματος
Blutegel	βδέλλα
Blutgefäß	αγγείο
Blutgruppe	ομάδα αίματος
Bluthochdruck	υπέρταση
Blutspende	αιμοδοσία
Blutsverwandtschaft	συγγένεια εξ αίματος
Bluttransfusion	μετάγγιση αίματος
Blutung	αιμορραγία
Blutvergießen	αιματοχυσία
Blutwurst	λουκάνικο αίματος
Bläschen	φουσκάλα
Blässe	ωχρότητα
Blässhuhn	φαλαρίδα
Blätterteig	σφολιάτα
Blätterwerk	φύλλωμα
Blöken	βέλασμα
Blüte	άνθος
Blütenlese	ανθολογία
Boa	βόας
Bochum	Μπόχουμ
Boden	έδαφος
Bogen	τόξο
Bogenschießen	τοξοβολία
Bogenschütze	τοξότης
Bohne	φασούλι
Bohnenkraut	θρούμπι
Bohrium	μπόριο
Boko Haram	Μπόκο Χαράμ
Bolivien	Βολιβία
Bologna	Μπολόνια
Bolschewik	μπολσεβίκος
Bombay	Βομβάη
Bombe	βόμβα
Bommel	φούντα
Bonaire	Μποναίρ
Bonn	Βόννη
Bonsai	μπονζάι
Boot	μπότα
Bor	βόριο
Bordeaux	Μπορντό
Bordell	μπουρδέλο
Bordkarte	επιβίβαση
Bornholm	Μπόρνχολμ
Borschtsch	μπορς
Borte	μπορντούρα
Bosnien	Βοσνία
Bosnien und Herzegowina	Βοσνία και Ερζεγοβίνη
Bosnien-Herzegowina	Βοσνία-Ερζεγοβίνη
Bosporus	Βόσπορος
Boss	αφεντικό
Boston	Βοστώνη
Botaniker	βοτανολόγος
Botschaft	μήνυμα
Botschafter	πρεσβευτής
Botschafterin	πρεσβευτής
Botsuana	Μποτσουάνα
Bottnischer Meerbusen	Βοθνιακός κόλπος
Bougainvillea	μπουκαμβίλια
Boulevard	λεωφόρος
Bourgeois	αστός
Boxen	πυγμαχία
Boxer	μπόξερ
Boykott	μποϊκοτάζ
Bozen	Μπολτζάνο
Brand	πυρκαγιά
Brandenburg	Βρανδεμβούργο
Brasilianerin	Βραζιλιάνα
Brasilien	Βραζιλία
Brasse	αβραμίδα
Bratislava	Μπρατισλάβα
Bratkartoffel	τηγανητές πατάτες
Bratpfanne	τηγάνι
Bratsche	βιόλα
Brauerei	ζυθοποιείο
Braunbär	καφέ αρκούδα
Brauner Knollenblätterpilz	Αμανίτης ο πάνθηρας
Braunkohle	λιγνίτης
Braut	νύφη
Brautjungfer	παράνυμφος
Brautkleid	νυφικό
Breite	πλάτος
Breitengrad	μοίρα γεωγραφικού πλάτους
Bremen	Βρέμη
Bremerhaven	Μπρεμερχάφεν
Bremse	πέδη
Brennnessel	τσουκνίδα
Breslau	Βρότσλαβ
Bretonisch	Βρετονικά
Brett	σανίδα
Brettspiel	επιτραπέζιο παιχνίδι
Bridge	μπριτζ
Brief	γράμμα
Briefkasten	γραμματοκιβώτιο
Briefmarke	γραμματόσημο
Brieftasche	πορτοφόλι
Briefträger	ταχυδρόμος
Briefumschlag	φάκελος
Briefwechsel	αλληλογραφία
Brille	γυαλιά
Brillenbär	αρκούδα των Άνδεων
Brise	μπάτης
Britisch-Kolumbien	Βρετανική Κολομβία
Brokkoli	μπρόκολο
Brom	βρώμιο
Brombeere	βατόμουρο
Bromberg	Μπιντγκός
Bronchitis	βρογχίτιδα
Bronx	Μπρονξ
Bronze	μπρούντζος
Bronzemedaille	χάλκινο μετάλλιο
Bronzezeit	Εποχή του Χαλκού
Brosche	καρφίτσα
Brot	ψωμί
Browser	περιήγηση
Bruch	θραύση
Bruder	αδελφός
Brunei	Μπρουνέι
Brunnen	πηγάδι
Brust	στήθος
Brustbein	στέρνο
Brustkorb	θώρακας
Brustwarze	θηλή
Bräutigam	γαμπρός
Brötchen	ψωμάκι
Brücke	γέφυρα
Brügge	Μπρυζ
Brüssel	Βρυξέλλες
Buch	βιβλίο
Buchbinder	βιβλιοδέτης
Buchbinderei	βιβλιοδετείο
Buche	οξιά
Buchfink	σπίνος
Buchhalter	λογιστής
Buchhaltung	λογιστήριο
Buchhandlung	βιβλιοπωλείο
Buchladen	βιβλιοπωλείο
Buchmesse	έκθεση
Buchrücken	ράχη
Buchstabe	γράμμα
Bucht	κόλπος
Buchweizen	φαγόπυρο
Buckelwal	μεγάπτερη
Budapest	Βουδαπέστη
Buddha	Βούδας
Buddhismus	βουδισμός
Buddhist	βουδιστής
Budget	προϋπολογισμός
Buenos Aires	Μπουένος Άιρες
Bug	πλώρη
Bukarest	Βουκουρέστι
Bukephalos	Βουκεφάλας
Bulgare	Βούλγαρος
Bulgarien	Βουλγαρία
Bulgarisch	Βουλγαρικά
Bulgur	πλιγούρι
Bulimie	βουλιμία
Bullauge	φινιστρίνι
Bulldogge	μπουλντόγκ
Bulldozer	μπουλντόζα
Bulle	μπάτσος
Bullenhai	ταυροκαρχαρίας
Bumerang	μπούμερανγκ
Bundeslade	Κιβωτός της Διαθήκης
Bundesland	ομόσπονδο κρατίδιο
Bundesrepublik	Ομοσπονδιακή Δημοκρατία
Bundesrepublik Deutschland	Ομοσπονδιακή Δημοκρατία της Γερμανίας
Bundeswehr	Μπούντεσβερ
Bungalow	μπαγκαλόου
Bunker	καταφύγιο
Buntspecht	παρδαλοτσικλιτάρα
Buntstift	ξυλομπογιά
Burg	κάστρο
Burgenland	Μπούργκενλαντ
Burgund	Βουργουνδία
Burka	μπούρκα
Burkina Faso	Μπουρκίνα Φάσο
Burkini	μπουρκίνι
Burrito	μπουρίτο
Burundi	Μπουρούντι
Bus	λεωφορείο
Busch	θάμνος
Busen	στήθος
Bushaltestelle	στάση λεωφορείου
Bussard	γερακίνα
Busuki	μπουζούκι
Butan	βουτάνιο
Butler	αρχιοικονόμος
Butter	βούτυρο
Buttermilch	βουτυρόγαλα
Buttersäure	βουτυρικό οξύ
Butō	Μπουτώ
Bydgoszcz	Μπιντγκός
Byzanz	Κωνσταντινούπολη
Bäcker	αρτοποιός
Bäckerei	αρτοποιείο
Bäckerin	φουρνάρισσα
Bär	αρκούδα
Bäuerchen	ρέψιμο
Béchamelsoße	μπεσαμέλ
Böhmen	Βοημία
Böotien	Βοιωτία
Börek	μπουρέκι
Börse	χρηματιστήριο
Bücherregal	ράφι βιβλιοθήκης
Bücherschrank	βιβλιοθήκη
Bücherwurm	βιβλιοσκώληξ
Büchse	κουτί
Büchsenmacher	οπλοποιός
Büfett	μπουφές
Büffel	βουβάλι
Bügelbrett	σιδερώστρα
Bügeleisen	σίδερο
Bühne	σκηνή
Bündnis	συμμαχία
Bürgerkrieg	εμφύλιος πόλεμος
Bürgermeister	δήμαρχος
Bürgermeisterin	δήμαρχος
Bürgerschaft	πολίτες
Bürgersteig	πεζοδρόμιο
Büro	γραφείο
Büroklammer	συνδετήρας
Bürokratie	γραφειοκρατία
Bürste	βούρτσα
Büstenhalter	σουτιέν
Cabo Verde	Πράσινο Ακρωτήριο
Cadmium	κάδμιο
Café	καφενείο
Calais	Καλαί
Calcium	ασβέστιο
Caldera	καλντέρα
Californium	καλιφόρνιο
Calvinismus	Καλβινισμός
Cambridge	Κέιμπριτζ
Camembert	καμαμπέρ
Camping	κατασκήνωση
Campus	πανεπιστημιούπολη
Canberra	Καμπέρα
Cannabis	κάνναβη
Canterbury	Καντέρμπερι
Canyon	φαράγγι
Cappuccino	καπουτσίνο
Caracas	Καράκας
Cardiff	Κάρντιφ
Catania	Κατάνια
Cayenne	Καγιέν
Celesta	τσελέστα
Cello	βιολοντσέλο
Cembalo	τσέμπαλο
Cent	λεπτό
Cer	δημητρίο
Ceuta	Θέουτα
Cevapcici	τσεβάπι
Cha-Cha-Cha	τσα τσα τσα
Chabarowsk	Χαμπάροφσκ
Chaiselongue	ανάκλιντρο
Chakra	τσάκρα
Champagne	Καμπανία
Champagner	σαμπάνια
Champions League	Τσάμπιονς Λιγκ
Chamäleon	χαμαιλέοντας
Chance	ευκαιρία
Chaos	χάος
Charakter	χαρακτήρας
Charakteristikum	χαρακτηριστικό
Charme	γοητεία
Charon	Χάρων
Chef	αφεντικό
Chefarzt	ἀρχιατρός
Chefredakteur	αρχισυντάκτης
Chemie	χημεία
Chemiker	χημικός
Chemnitz	Κέμνιτς
Chemotherapie	χημειοθεραπεία
Chiasma	χίασμα
Chicago	Σικάγο
Chile	Χιλή
China	Κίνα
Chinese	Κινέζος
Chinesin	Κινέζα
Chinesisch	Κινέζικα
Chinin	κινίνη
Chip	πατατάκι
Chirurg	χειρουργός
Chirurgie	χειρουργική
Chlor	χλώριο
Chlorophyll	χλωροφύλλη
Cholera	χολέρα
Choleriker	χολερικός
Cholesterin	χοληστερίνη
Cholin	χολίνη
Chor	χορωδία
Chor	χορωδία
Choreografie	χορογραφία
Chorist	χορωδός
Chorsänger	χορωδός
Christ	χριστιανός
Christentum	χριστιανισμός
Christi Himmelfahrt	Ανάληψη
Christian	Χριστιανός
Christianisierung	εκχριστιανισμός
Christoph	Χριστόφορος
Christus	Χριστός
Chrom	χρώμιο
Chromatographie	χρωματογραφία
Chromosom	χρωμόσωμα
Chronologie	χρονολογία
Chronometer	χρονόμετρο
Chruschtschow	Χρουστσόφ
Cidre	μηλίτης
Clown	κλόουν
Cocktail	κοκτέιλ
Cola	κόλα
Computer	υπολογιστής
Computermaus	ποντίκι
Computertastatur	πληκτρολόγιο
Conditio sine qua non	προϋπόθεση
Container	εμπορευματοκιβώτιο
Cookinseln	Νήσοι Κουκ
Copernicium	κοπερνίκιο
Cornwall	Κορνουάλη
Coronavirus	κοροναϊός
Cortisol	κορτιζόλη
Costa Rica	Κόστα Ρίκα
Couch	καναπές
Coulomb	κουλόμπ
Couscous	κουσκούς
Cousin	ξάδελφος
Cousine	ξαδέλφη
Creme	κρέμα
Crew	πλήρωμα
Cricket	κρίκετ
Cunnilingus	αιδοιολειξία
Curaçao	Κουρασάο
Curium	κιούριο
Cycloalkan	κυκλοαλκάνιο
Cymbal	σαντούρι
Cystein	κυστεΐνη
Cádiz	Κάδιξ
Cäsium	καίσιο
Dachs	ασβός
Dadaismus	ντανταϊσμός
Daktylus	δάκτυλος
Dallas	Ντάλας
Damaskus	Δαμασκός
Dame	κυρία
Damhirsch	πλατώνι
Damoklesschwert	Δαμόκλειος σπάθη
Dampf	ατμός
Dampfschiff	ατμόπλοιο
Dampfschifffahrt	ατμοπλοΐα
Daniel	Ντάνιελ
Dankbarkeit	ευγνωμοσύνη
Danzig	Γκντανσκ
Daphne	Δάφνη
Dardanellen	Δαρδανέλλια
Darm	έντερο
Darmstadt	Ντάρμστατ
Darmstadtium	νταρμστάντιο
Datei	αρχείο
Dativ	δοτική
Dattel	χουρμάς
Datum	ημερομηνία
Dauer	διάρκεια
Dauerlauf	δρόμος αντοχής
Daumen	αντίχειρας
David	Δαβίδ
Davidstern	Άστρο του Δαβίδ
Davos	Νταβός
Debian	Debian
Debüt	ντεμπούτο
Deck	κατάστρωμα
Decke	κουβέρτα
Deckel	καπάκι
Deep Learning	βαθιά μάθηση
Deern	κοπέλα
Defibrillator	απινιδωτής
Definition	ορισμός
Deflation	αποπληθωρισμός
Defloration	διακόρευση
Defragmentierung	ανασυγκρότηση
Defätismus	ηττοπάθεια
Deich	ανάχωμα
Deismus	ντεϊσμός
Deklination	κλίση
Dekokt	αφέψημα
Dekret	διάταγμα
Delaware	Ντέλαγουερ
Delegation	αποστολή
Delfin	δελφίνι
Delirium	παραλήρημα
Delta	δέλτα
Demenz	άνοια
Demokrat	δημοκράτης
Demokratie	δημοκρατία
Demokratin	δημοκράτισσα
Demokratische Republik Kongo	Λαϊκή Δημοκρατία του Κονγκό
Demokratische Volksrepublik Algerien	Λαϊκή Δημοκρατία της Αλγερίας
Demokratische Volksrepublik Korea	Λαοκρατική Δημοκρατία της Κορέας
Demonstration	διαδήλωση
Den Haag	Χάγη
Denken	σκέψη
Denkmal	μνημείο
Depression	κατάθλιψη
Dermatitis	δερματίτις
Dermatologe	δερματολόγος
Dermatologie	δερματολογία
Deserteur	λιποτάκτης
Desinformation	παραπληροφόρηση
Desoxyribonukleinsäure	δεοξυριβονουκλεϊκό οξύ
Dessert	επιδόρπιο
Destillation	απόσταξη
Detail	λεπτομέρεια
Detektiv	ντετέκτιβ
Determinante	ορίζουσα
Determinismus	αιτιοκρατία
Detroit	Ντιτρόιτ
Deus ex Machina	από μηχανής θεός
Deuterium	δευτέριο
Deuteronomium	Δευτερονόμιο
Deutsch	γερμανικά
Deutsche	Γερμανίδα
Deutsche Demokratische Republik	Λαϊκή Δημοκρατία της Γερμανίας
Deutscher	Γερμανός
Deutsches Reich	Γερμανικό Ράιχ
Deutschland	Γερμανία
Deziliter	δεκατόλιτρο
Diabetes	διαβήτης
Diabetiker	διαβητικός
Diagnose	διάγνωση
Diagramm	διάγραμμα
Dialekt	διάλεκτος
Dialektologie	διαλεκτολογία
Dialog	διάλογος
Diamant	διαμάντι
Diamant	διαμάντι
Dichte	πυκνότητα
Dichter	ποιητής
Dichterin	ποιήτρια
Dichterling	στιχοπλόκος
Dichtungsring	ροδέλα στεγανότητας
Dickdarm	παχύ έντερο
Dickkopf	ξεροκέφαλος
Dieb	κλέφτης
Diebstahl	κλοπή
Diele	χολ
Dienstag	Τρίτη
Dienstfahrzeug	υπηρεσιακό αυτοκίνητο
Dienstleistung	υπηρεσία
Diesel	ντίζελ
Diglossie	διγλωσσία
Diktat	ορθογραφία
Diktator	δικτάτορας
Diktatur	δικτατορία
Dildo	δονητής m
Dilemma	δίλημμα
Dilettant	ερασιτέχνης
Dill	άνηθος
Diminutiv	υποκοριστικό
Ding	πράγμα
Dinkel	όλυρα
Dinosaurier	δεινόσαυρος
Diode	δίοδος
Dioxid	διοξείδιο
Diphtherie	διφθερίτιδα
Diphthong	δίφθογγος
Diplomatie	διπλωματία
Direktor	διευθυντής
Dirigent	μαέστρος
Diskothek	δισκοθήκη
Diskriminierung	διάκριση
Diskussion	συζήτηση
Distel	γαϊδουράγκαθο
Distraktion	διασκέδαση
Disziplin	πειθαρχία
Dnister	Δνείστερος
Doge	δόγης
Dogma	δόγμα
Doha	Ντόχα
Dohle	κάργια
Dokumentarfilm	ντοκιμαντέρ
Dolch	στιλέτο
Dollar	δολάριο
Dolmetscher	διερμηνέας
Dominica	Ντομίνικα
Dominikanische Republik	Δομινικανή Δημοκρατία
Don Quijote	δον Κιχώτης
Donald Duck	Ντόναλντ Ντακ
Donau	Δούναβης
Donner	βροντή
Donnerstag	Πέμπτη
Doppelgänger	σωσίας
Doppelkinn	διπλοσάγονο
Doppelkopf	είδος γερμανικού χαρτοπαίγνιου
Dorade	τσιπούρα
Dorf	χωριό
Dorn	αγκάθι
Dorothea	Δωροθέα
Dorsch	μπακαλιάρος
Dortmund	Ντόρτμουντ
Drache	δράκος
Drachen	χαρταετός
Drachme	δραχμή
Draht	σύρμα
Drahtseil	συρματόσχοινο
Drama	δράμα
Draufgänger	καταφερτζής
Drehbuchautor	σεναριογράφος
Dreieck	τρίγωνο
Dreiklang	συγχορδία
Dreizack	τρίαινα
Dreschflegel	κόπανος
Dresden	Δρέσδη
Drittel	τρίτο
Drogerie	φαρμακοπωλείο
Drohne	κηφήνας
Drossel	τσίχλα
Druck	πίεση
Druckausgleich	εξισορρόπηση πίεσης
Drucker	εκτυπωτής
Druckfehler	παρόραμα
Drüse	αδένας
Dschibuti	Τζιμπουτί
Dschihad	τζιχάντ
Dschihadist	τζιχαντιστής
Dschinn	τζίνι
Dualismus	Καλό και κακό
Dubai	Ντουμπάι
Dublin	Δουβλίνο
Dubnium	ντούμπνιο
Dudelsack	γκάιντα
Duft	άρωμα
Duisburg	Ντούισμπουργκ
Dunkelheit	σκοτάδι
Dunkelkammer	σκοτεινός θάλαμος
Dunkle Energie	σκοτεινή ενέργεια
Dunstabzugshaube	απορροφητήρας
Dur	ματζόρε
Durchfall	διάρροια
Durchmesser	διάμετρος
Durchschnitt	μέσος όρος
Durst	δίψα
Duschanbe	Ντουσαμπέ
Dusche	ντους
Dutzend	δωδεκάδα
Dynamit	δυναμίτης
Dynamo	δυναμό
Dynastie	δυναστεία
Dysprosium	δυσπρόσιο
Dysthymie	δυσθυμία
Dämmerung	σούρουπο
Dämon	δαίμονας
Däne	Δανός
Dänemark	Δανία
Dänisch	δανικά
Döner	γύρος
Döner Kebab	ντόνερ κεμπάπ
Düne	αμμόλοφος
Dünger	λίπασμα
Dürre	ανομβρία
Düsseldorf	Ντίσελντορφ
E-Mail	ημέιλ
E-Mail-Adresse	διεύθυνση ηλεκτρονικού ταχυδρομείου
EU	ΕΕ
Ebene	επίπεδο
Ebenholz	ἐβενος
Eber	κάπρος
Echo	ηχώ
Ecke	γωνία
Eckernförde	Εκερνφέρντε
Eckfahne	σημαία του κόρνερ
Ecuador	Ισημερινός
Edelmetall	ευγενές μέταλλο
Edelstein	πολύτιμος λίθος
Edessa	Έδεσσα
Edikt	διάταγμα
Edition	έκδοση
Eduard	Εδουάρδος
Efeu	κισσός
Effektivität	αποτελεσματικότητα
Egge	σβάρνα
Ehe	γάμος
Ehebrecher	μοιχός
Ehebrecherin	μοιχαλίδα
Ehebruch	μοιχεία
Ehefrau	σύζυγος
Ehegatte	σύζυγος
Eheleute	σύζυγοι
Ehelosigkeit	αγαμία
Ehemann	σύζυγος
Ehepaar	αντρόγυνο
Ehepartner	σύζυγος
Ehepartnerin	σύζυγος
Ehering	βέρα
Ehevertrag	προγαμιαία συμφωνία
Ehre	τιμή
Ehrgeiz	φιλοδοξία
Ehrlichkeit	ειλικρίνεια
Ei	αβγό
Eibe	τάξος
Eiche	βελανιδιά
Eichel	βελανίδι
Eichelhäher	κίσσα
Eichhörnchen	σκίουρος
Eid	όρκος
Eidechse	σαύρα
Eierstock	ωοθήκη
Eifer	ζήλος
Eifersucht	ζήλια
Eiffelturm	Πύργος του Άιφελ
Eigelb	κροκάδι
Eigenheit	ιδιομορφία
Eigenname	κύριο όνομα
Eigennutz	ιδιοτέλεια
Eigenschaft	ιδιότητα
Eigenschaftswort	επίθετο
Eigentum	ιδιοκτησία
Eigentümer	ιδιοκτήτης
Eigentümerin	ιδιοκτήτρια
Eigenwert	ιδιοτιμή
Eileiter	σάλπιγγα
Eimer	κουβάς
Einbrecher	διαρρήκτης
Einbruch	διάρρηξη
Einbürgerung	πολιτογράφηση
Einfachheit	απλότητα
Einfall	ιδέα
Einfallswinkel	πρόσπτωση
Einführung	εισαγωγή
Eingang	είσοδος
Eingeborener	ιθαγενής
Eingeweide	έντερα
Eingliederung	ενσωμάτωση
Einheit	ενότητα
Einhorn	μονόκερως
Einkaufswagen	καροτσάκι
Einkaufswagerl	καροτσάκι
Einkaufszentrum	εμπορικό κέντρο
Einkommen	εισόδημα
Einladung	πρόσκληση
Einleitung	εισαγωγή
Einmachglas	βάζο
Einsamkeit	μοναξιά
Einschätzung	εκτίμηση
Einsteinium	αϊνστάνιο
Einsturz	κατάρρευση
Eintrittskarte	εισιτήριο
Einwanderer	μετανάστης
Einwanderung	μετανάστευση
Einwirkung	επίδραση
Einwohner	κάτοικος
Einzel	μονό
Einzelhandel	λιανεμπόριο
Einzelhändler	λιανέμπορος
Einzelkind	μοναχοπαίδι
Eis	πάγος
Eis am Stiel	παγωτό ξυλάκι
Eisberg	παγόβουνο
Eisbrecher	παγοθραυστικό
Eisbär	πολική αρκούδα
Eisen	σίδηρος
Eisenach	Άιζεναχ
Eisenbahn	σιδηρόδρομος
Eisenwaren	σιδερικά
Eisenzeit	Εποχή του Σιδήρου
Eishockey	χόκεϊ επί πάγου
Eiskarte	μενού παγωτού
Eiskugel	boule de glace
Eistaucher	παγοβούτι
Eistee	pagoméno tsái
Eisvogel	αλκυόνη
Eiswürfel	παγάκι
Eiter	πύον
Eiweiß	ασπράδι
Eizelle	ωάριο
Ejakulation	εκσπερμάτωση
Ekliptik	εκλειπτική
Ektoplasma	εκτόπλασμα
El Salvador	Ελ Σαλβαδόρ
Elativ	υπερθετικός
Elbe	Έλβας
Elbphilharmonie	Φιλαρμονία του Έλβα
Elch	άλκη
Elefant	ελέφαντας
Elegie	ελεγεία
Elektrizität	ηλεκτρισμός
Elektrizitätswerk	σταθμός
Elektrode	ηλεκτρόδιο
Elektroenzephalografie	ηλεκτροεγκεφαλογραφία
Elektrogerät	συσκευή
Elektrolyt	ηλεκτρολύτης
Elektromagnetismus	ηλεκτρομαγνητισμός
Elektromotor	ηλεκτροκινητήρας
Elektron	ηλεκτρόνιο
Elektronegativität	ηλεκτραρνητικότητα
Elektronenröhre	ηλεκτρονική λυχνία
Elektronik	ηλεκτρονική
Elektrostatik	ηλεκτροστατική
Element	στοιχείο
Elementarteilchen	στοιχειώδες σωματίδιο
Elephantine	Ελεφάντινη
Elf	έντεκα
Elfenbein	ελεφαντόδοντο
Elfenbeinküste	Ακτή Ελεφαντοστού
Elisabeth	Ελισάβετ
Ellbogen	αγκώνας
Ellipse	έλλειψη
Elmsfeuer	Άγιοι Νικόληδες
Elsass	Αλσατία
Elster	καρακάξα
Elsässer	Αλσατός
Eltern	γονείς
Elternteil	γονέας
Emanzipation	χειραφέτηση
Emblem	έμβλημα
Emir	εμίρης
Emirat	εμιράτο
Emmentaler	έμενταλ
Emoji	εμότζι
Empathie	ενσυναίσθηση
Empirismus	εμπειρισμός
Emu	εμού
Emulsion	γαλάκτωμα
Enceladus	Εγκέλαδος
Ende	τέλος
Ende gut, alles gut	τέλος καλό, όλα καλά
Endstation	τέρμα
Endung	κατάληξη
Energie	ενέργεια
Engagement	συμβόλαιο
Engel	άγγελος
England	Αγγλία
Englisch	αγγλικά
Engländer	Άγγλος
Engländerin	Αγγλίδα
Enkel	εγγονός
Enkelin	εγγονή
Enkelkind	εγγόνι
Entdecker	εξερευνητής
Entdeckung	ανακάλυψη
Ente	πάπια
Entente	συνεννόηση
Entfaltung	ανάπτυξη
Entführung	απαγωγή
Enthalpie	ενθαλπία
Enthauptung	αποκεφαλισμός
Enthüllung	αποκάλυψη
Entjungferung	διακόρευση
Entlassung	απόλυση
Entlehnung	δάνειο
Entropie	εντροπία
Entscheidung	απόφαση
Entschlossenheit	αποφασιστικότητα
Entschädigung	αποζημίωση
Entspannung	χαλάρωση
Enttäuschung	απογοήτευση
Entwicklung	ανάπτυξη
Entzug	αποτοξίνωση
Entzündung	φλεγμονή
Enzyklopädie	εγκυκλοπαίδεια
Enzym	ένζυμο
Ephelide	εφηλίδα
Epheserbrief	Εφεσίους
Epidemie	επιδημία
Epidemiologie	επιδημιολογία
Epigramm	επίγραμμα
Epilepsie	επιληψία
Epilimnion	επιλίμνιο
Epiphanie	θεοφάνεια
Episode	επεισόδιο
Epistaxis	επίσταξη
Epizentrum	επίκεντρο
Epoche	εποχή
Epsilon	έψιλον
Erbarmen	οίκτος
Erbe	κληρονόμος
Erbe	κληρονομιά
Erbium	έρβιο
Erblasser	κληροδότης
Erbschaft	κληρονομιά
Erbse	μπιζέλι
Erbsünde	προπατορικό αμάρτημα
Erdapfel	γεώμηλο
Erdbeben	σεισμός
Erdbeerbaum	κουμαριά
Erdbeere	φράουλα
Erdbevölkerung	πληθυσμός
Erde	γη
Erdgas	φυσικό αέριο
Erdkruste	γήινος φλοιός
Erdnuss	φυστίκι
Erdoberfläche	επιφάνεια της γης
Erdreich	χώμα
Erdrutsch	κατολίσθηση
Erdöl	πετρέλαιο
Ereignis	γεγονός
Erektion	στύση
Erfahrung	πείρα
Erfindung	εφεύρεση
Erfolg	επιτυχία
Erfurt	Ερφούρτη
Erfüllung	εκπλήρωση
Ergebnis	αποτέλεσμα
Ergonomie	εργονομία
Erholung	ανάπαυση
Erika	Έρικα
Erinnerung	μνήμη
Eritrea	Ερυθραία
Erklärung	εξήγηση
Erkrankung	αρρώστια
Erkältung	κρυολόγημα
Erle	σκλήθρα
Erlebnis	εμπειρία
Erleichterung	ανακούφιση
Erlösung	λύτρωση
Ermordung	δολοφονία
Ernte	σοδειά
Ernährung	διατροφή
Eroberung	κατάκτηση
Eros	Έρως
Erosion	αποσάθρωση
Erpressung	εκβιασμός
Erscheinungsbild	φυσιογνωμία
Erste Hilfe	βοήθεια
Erster Weltkrieg	Α΄ Παγκόσμιος Πόλεμος
Erwachsener	ενήλικος
Erwartung	προσδοκία
Erweiterung	διεύρυνση
Erwiderung	απάντηση
Erz	μετάλλευμα
Erzbischof	αρχιεπίσκοπος
Erzengel	αρχάγγελος
Erzeugnis	προϊόν
Erzherzog	αρχιδούκας
Erzieher	παιδαγωγός
Erzieherin	παιδαγωγός
Erziehung	αγωγή
Erzählung	αφήγηση
Esbjerg	Έσμπιεργκ
Eschatologie	εσχατολογία
Esche	μελιά
Esel	γάιδαρος
Esperanto	Εσπεράντο
Espresso	εσπρέσο
Esra	Έσδρας
Essen	φαγητό
Essentialismus	ουσιοκρατία
Essenz	ουσία
Essig	ξύδι
Essigsäure	οξικό οξύ
Esslöffel	κουτάλι
Esszimmer	τραπεζαρία
Este	Εσθονός
Ester	εστέρας
Esther	Εσθήρ
Esther	Εσθήρ
Estin	Εσθονή
Estland	Εσθονία
Estnisch	Εσθονικά
Estragon	εστραγκόν
Etagere	εταζέρα
Ethan	αιθάνιο
Ethik	ηθική
Ethnograf	εθνογράφος
Ethologie	ηθολογία
Ethylendiamintetraessigsäure	αιθυλομενοδιαμινοτετραοξικό οξύ
Etymologie	ετυμολογία
Eugen	Ευγένιος
Euklid	Ευκλείδης
Eule	κουκουβάγια
Eulen nach Athen tragen	κομίζω γλαύκα εις Αθήνας
Eunuch	ευνούχος
Euphemismus	ευφημισμός
Euphorie	ευφορία
Eurasien	Ευρασία
Euro	ευρώ
Europa	Ευρώπη
Europa	Ευρώπη
Europameister	πρωταθλητής
Europameisterschaft	πρωτάθλημα
Europawahl	ευρωεκλογή
Europium	ευρώπιο
Europäer	Ευρωπαίος
Europäische Agentur für Flugsicherheit	Ευρωπαϊκός οργανισμός ασφάλειας της αεροπορίας
Europäische Agentur für die Sicherheit des Seeverkehrs	Ευρωπαϊκός Οργανισμός για την Ασφάλεια στη Θάλασσα
Europäische Arzneimittelagentur	Ευρωπαϊκός Οργανισμός Φαρμάκων
Europäische Behörde für Lebensmittelsicherheit	Ευρωπαϊκή Aρχή για την Ασφάλεια των Τροφίμων
Europäische Eisenbahnagentur	Ευρωπαϊκός Οργανισμός Σιδηροδρόμων
Europäische Umweltagentur	Ευρωπαϊκός Οργανισμός Περιβάλλοντος
Europäische Union	Ευρωπαϊκή Ένωση
Europäische Zentralbank	Ευρωπαϊκή Κεντρική Τράπεζα
Europäischer Gerichtshof für Menschenrechte	Ευρωπαϊκό Δικαστήριο Ανθρωπίνων Δικαιωμάτων
Europäischer Rat	Ευρωπαϊκό Συμβούλιο
Europäisches Parlament	Ευρωπαϊκό Κοινοβούλιο
Europäisierung	εξευρωπαϊσμός
Eurozone	Ευρωζώνη
Euter	μαστός
Euterpe	Ευτέρπη
Euthanasie	ευθανασία
Eva	Εύα
Eva	Εύα
Evakuierung	εκκένωση
Evangelium	ευαγγέλιο
Evolution	εξέλιξη
Ewigkeit	αιωνιότητα
Examen	διαγώνισμα
Exegese	εξήγηση
Exil	εξορία
Existentialismus	υπαρξισμός
Existenz	ύπαρξη
Exkurs	παρέκβαση
Exodus	Έξοδος
Exoplanet	εξωπλανήτης
Exorzismus	εξορκισμός
Exorzist	εξορκιστής
Exotismus	εξωτισμός
Experiment	πείραμα
Experte	ειδικός
Explosion	έκρηξη
Exponat	έκθεμα
Exzerpt	απόσπασμα
Exzision	εκτομή
Ezechiel	Ιεζεκιήλ
FIFA	ΦΙΦΑ
FKK-Strand	παραλία γυμνιστών
Fabrik	εργοστάσιο
Fachbuch	βιβλίο
Fachjargon	ορολογία
Fackel	πυρσός
Fagott	φαγκότο
Fahne	σημαία
Fahrer	οδηγός
Fahrerlaubnis	οδήγηση
Fahrplan	δρομολόγιο
Fahrrad	ποδήλατο
Fahrzeug	όχημα
Fakelaki	φακελάκι
Faktor	παράγοντας
Faktotum	παντοποιός
Fakultät	σχολή
Falke	γεράκι
Falklandinseln	Νήσοι Φώκλαντ
Fall	περίπτωση
Fallbeil	γκιλοτίνα
Falle	παγίδα
Fallschirm	αλεξίπτωτο
Falltür	καταπακτή
Falte	ζάρα
Familie	οικογένεια
Familienname	επώνυμο
Familienstand	οικογενειακή
Fang	ψάρεμα
Fantasie	φαντασία
Farad	Φαράντ
Faradaykäfig	θωράκιση Faraday
Farbe	χρώμα
Farbstift	κραγιόνι
Farn	φτέρη
Fasan	φασιανός
Faschismus	φασισμός
Faschist	φασίστας
Faser	ίνα
Fass	βαρέλι
Fassade	πρόσοψη
Fast Food	ταχυφαγείο
Fasten	νηστεία
Fastenzeit	νηστεία
Faulpelz	τεμπελόσκυλο
Faultier	βραδύπους
Faun	Παν
Fauna	πανίδα
Faust	γροθιά
Faustpfand	κινο ενέχυρο
Fechten	ξιφομαχία
Feder	φτερό
Fee	νεράιδα
Fegefeuer	καθαρτήριο
Fehler	λάθος
Fehlgeburt	αποβολή
Feiertag	γιορτή
Feige	σύκο
Feigenbaum	συκιά
Feigheit	δειλία
Feile	λίμα
Feind	εχθρός
Feindseligkeit	εχθρότητα
Felchen	κορέγονος
Feld	χωράφι
Feldbett	ράντζο
Feldwebel	λοχίας
Fell	γούνα
Fellatio	πεολειξία
Fels	βράχος
Feminismus	φεμινισμός
Fenchel	μάραθο
Fenster	παράθυρο
Fensterscheibe	τζάμι
Ferien	διακοπές
Ferienhaus	εξοχικό
Ferkel	γουρουνόπουλο
Fermion	φερμιόνιο
Fermium	φέρμιο
Fernbedienung	τηλεχειριστήριο
Fernglas	κιάλια
Fernost	Άπω Ανατολή
Fernsehen	τηλεόραση
Fernsehgerät	τηλεόραση
Fernsprecher	τηλέφωνο
Fernweh	επιθυμία
Ferse	φτέρνα
Fertigkeit	επιδεξιότητα
Fest	γιορτή
Festakt	τελετή
Festival	φεστιβάλ
Festland	ξηρά
Festnahme	σύλληψη
Festplatte	σκληρός δίσκος
Festung	φρούριο
Feta	φέτα
Fett	λίπος
Fettabscheider	λιποδιαχωριστής
Fettsäure	λιπαρό οξύ
Fetus	έμβρυο
Feuer	φωτιά
Feuerland	Γη του Πυρός
Feuerlöscher	πυροσβεστήρας
Feuerwehr	πυροσβεστική
Feuerwehrauto	πυροσβεστική
Feuerwehrleute	πυροσβέστες
Feuerwehrmann	πυροσβέστης
Feuerzeug	αναπτήρας
Fiasko	φιάσκο
Fichte	ερυθρελάτη
Fidschi	Φίτζι
Fieber	πυρετός
Film	μεμβράνη
Filter	φίλτρο
Filterkaffee	γαλλικός
Filzstift	μαρκαδόρος
Finale	τελικός
Finanzbuchhaltung	χρηματοοικονομικός
Finanzierung	χρηματοδότηση
Finanzkrise	χρηματοοικονομική κρίση
Findelkind	έκθετο
Finger	δάχτυλο
Fingerabdruck	δακτυλικό αποτύπωμα
Fingerhut	δακτυλήθρα
Fingernagel	νύχι
Fingerspitze	ακροδάχτυλο
Fink	σπίνος
Finnisch	φινλανδικά
Finnland	Φινλανδία
Firma	επιχείρηση
Firnis	βερνίκι
Fisch	ψάρι
Fischer	ψαράς
Fischerboot	ψαρόβαρκα
Fischfang	αλιεία
Fischflosse	πτερύγιο
Fischgeschäft	ιχθυοπωλείο
Fischgräte	ψαροκόκκαλο
Fischladen	ψαράδικο
Fischschuppe	λέπι ψαριού
Fischsuppe	ψαρόσουπα
Fjord	φιόρδ
Fladenbrot	λαγάνα
Flagge	σημαία
Flamingo	φλαμίνγκο
Flamme	φλόγα
Flansch	φλάντζα
Flasche	μπουκάλι
Flechte	λειχήνα
Fleck	κηλίδα
Fledermaus	νυχτερίδα
Fleisch	κρέας
Fleischer	κρεοπώλης
Fleischspieß	σουβλάκι
Fleiß	επιμέλεια
Flensburg	Φλένσμπουργκ
Flerovium	φλερόβιο
Flexion	κλίση
Flieder	πασχαλιά
Fliege	μύγα
Flieger	αεροπόρος
Flitterwochen	μήνας του μέλιτος
Floh	ψύλλος
Flohmarkt	υπαίθριο παζάρι
Flora	χλωρίδα
Florenz	Φλωρεντία
Florida	Φλόριντα
Flosse	πτερύγιο
Flotte	στόλος
Floß	σχεδία
Fluch	κατάρα
Flucht	φυγή
Flug	πέταγμα
Flughafen	αεροδρόμιο
Flugzeug	αεροπλάνο
Flugzeugträger	αεροπλανοφόρο
Flunder	φασί
Fluor	φθόριο
Fluoreszenz	φθορισμός
Flur	διάδρομος
Fluss	ποταμός
Flussgebietseinheit	περιοχή λεκάνης απορροής ποταμού
Flusskrebs	ποταμοκαραβίδα
Flusspferd	ιπποπόταμος
Flussregenpfeifer	ποταμοσφυριχτής
Flut	πλημμυρίδα
Fläche	έκταση
Flächeninhalt	εμβαδόν
Flöte	φλάουτο
Flötenspieler	αυλητής
Flötist	φλαουτίστας
Flüchtling	πρόσφυγας
Flüchtlingslager	καταυλισμός προσφύγων
Flügel	φτερό
Flüssigkeit	υγρό
Focaccia	φοκάτσια
Fohlen	πουλάρι
Folge	συνέπεια
Forelle	πέστροφα
Form	σχήμα
Formaldehyd	φορμαλδεΰδη
Formel	τύπος
Formular	έντυπο
Forscher	ερευνητής
Forscherin	ερευνήτρια
Forschung	έρευνα
Forsthaus	δασοκομείο
Fortschritt	πρόοδος
Fossil	απολίθωμα
Foto	φωτογραφία
Fotograf	φωτογράφος
Fotografie	φωτογραφία
Fotze	μουνί
Foyer	φουαγιέ
Frachtschiff	φορτηγό πλοίο
Frage	ερώτηση
Fragebogen	ερωτηματολόγιο
Fragezeichen	ερωτηματικό
Francium	φράγκιο
Franke	Φράγκος
Franken	Φραγκονία
Frankfurt	Φρανκφούρτη
Frankreich	Γαλλία
Franzose	Γάλλος
Französin	Γαλλίδα
Französisch	γαλλικά
Französisch-Guayana	Γαλλική Γουιάνα
Französisch-Polynesien	Γαλλική Πολυνησία
Französische Republik	Γαλλική Δημοκρατία
Französische Revolution	επανάσταση
Frau	γυναίκα
Frauenarzt	γυναικολόγος
Fregatte	φρεγάτα
Freiburg	Φράιμπουργκ
Freihandelszone	ζώνη ελεύθερων συναλλαγών
Freiheit	ελευθερία
Freiheitsstatue	άγαλμα της Ελευθερίας
Freikörperkultur	γυμνισμός
Freiland	ανοικτό έδαφος
Freitag	Παρασκευή
Freizeit	ελεύθερος χρόνος
Fremde	ξένη
Fremdenführer	ξεναγός
Fremdenverkehr	τουρισμός
Fremder	ξένος
Fremdsprache	γλώσσα
Fremdwährung	ξένο νόμισμα
Frequenz	συχνότητα
Fresko	νωπογραφία
Frettchen	κουνάβι
Freude	χαρά
Freund	φίλος
Freundeskreis	παρέα
Freundin	φίλη
Freundschaft	φιλία
Frieden	ειρήνη
Friedensstifter	ειρηνοποιός
Friedhof	κοιμητήριο
Friedrich	Φρειδερίκος
Fries	ζωφόρος
Friese	φριζικά
Frigidität	ψυχρότητα
Frikadelle	κεφτές
Friseur	κομμωτής
Friseurin	κομμώτρια
Friseursalon	κομμωτήριο
Frist	διορία
Frisur	κόμμωση
Front	μέτωπο
Frosch	βάτραχος
Froschmann	βατραχάνθρωπος
Frost	παγετός
Frostbeule	χιονίστρα
Frucht	καρπός
Fräulein	δεσποινίς
Frömmigkeit	ευλάβεια
Frühchen	πρόωρος
Frühjahr	άνοιξη
Frühling	άνοιξη
Frühlingsrolle	ρολό της άνοιξης
Frühstück	πρωινό
Fuchs	αλεπού
Fuerteventura	Φουερτεβεντούρα
Fuge	αρμός
Fulda	Φούλντα
Fulda	Φούλντα
Fumarole	φουμαρόλη
Fundamentalismus	φονταμενταλισμός
Fundgrube	πηγή
Funke	σπίθα
Funktion	λειτουργία
Furche	αυλάκι
Furcht	φόβος
Furnier	καπλαμάς
Futter	ζωοτροφή
Fuß	πόδι
Fußabtreter	πατάκι
Fußball	ποδόσφαιρο
Fußballspieler	ποδοσφαιριστής
Fußboden	δάπεδο
Fußgängerzone	πεζόδρομος
Fußpilz	πόδι αθλητή
Fußweg	μονοπάτι
Fächer	βεντάλια
Fähigkeit	ικανότητα
Fähre	φέριμποτ
Färöer	Φερόες
Fäule	σήψη
Föderationskreis	ομοσπονδιακά Διαμερίσματα της Ρωσίας
Föderierte Staaten von Mikronesien	Ομόσπονδες Πολιτείες της Μικρονησίας
Förderer	υποστηρικτής
Förster	δασονόμος
Führerschein	άδεια οδήγησης
Fülle	πλήθος
Fünfkampf	πένταθλο
Fürbitte	παράκληση
Fürst	πρίγκιπας
Fürstentum	πριγκιπάτο
Fürstentum Andorra	Πριγκιπάτο της Ανδόρας
Fürwort	αντωνυμία
Füssen	Φύσεν
Gabardine	γκαμπαρντίνα
Gabel	πιρούνι
Gabelschlüssel	γερμανικό κλειδί
Gabelstapler	περονοφόρο
Gabriel	Γαβριήλ
Gabun	Γκαμπόν
Gadolinium	γαδολίνιο
Galaxie	γαλαξίας
Galaxis	Γαλαξίας
Galeere	γαλέρα
Galeone	γαλιόνι
Galerie	στοά
Galgen	αγχόνη
Galionsfigur	ακρόπρωρο
Galle	χολή
Gallenblase	χοληδόχος
Gallien	Γαλατία
Gallium	γάλλιο
Gallussäure	κηκιδικό οξύ
Gambia	Γκάμπια
Gambia	Γκάμπια
Gamma	γάμμα
Gammelfleisch	σάπιος
Gang	βάδισμα
Ganges	Γάγγης
Gangster	γκάνγκστερ
Gans	χήνα
Garage	γκαράζ
Garbe	δεμάτι
Garonne	Γαρούνας
Garten	κήπος
Gas	αέριο
Gasgeruch	οσμή αερίου
Gaskammer	θάλαμος αερίων
Gasse	σοκάκι
Gast	καλεσμένος
Gastgeber	οικοδεσπότης
Gastmannschaft	ομάδα
Gastroschisis	γαστρόσχιση
Gastwirt	εστιάτορας
Gate	πύλη
Gattung	γένος
Gaumen	ουρανίσκος
Gazastreifen	Λωρίδα της Γάζας
Gazelle	γαζέλα
Gebet	προσευχή
Gebirge	βουνό
Gebirgskette	οροσειρά
Gebot	εντολή
Gebrauchsanweisung	οδηγία
Geburt	τοκετός
Geburtenrate	γεννητικότητα
Geburtsdatum	γέννηση
Geburtsort	γέννηση
Geburtstag	ημερομηνία
Gebärmutter	μήτρα
Gebäude	κτίριο
Gebühr	τέλη
Gecko	σαμιαμίδι
Gedanke	σκέψη
Gedankenstrich	παύλα
Gedicht	ποίημα
Geduld	υπομονή
Gedächtnis	μνημονικό
Gefahr	κίνδυνος
Gefahrenquelle	εστία
Gefangener	κρατούμενος
Gefieder	πτέρωμα
Geflügel	πουλερικά
Gefrierschrank	καταψύκτης
Gefährdung	διακινδύνευση
Gefängnis	φυλακή
Gefäß	δοχείο
Gefühl	αίσθημα
Gegenfinanzierung	χρηματοδότηση
Gegenleistung	αντάλλαγμα
Gegenpapst	αντίπαπας
Gegenstand	αντικείμενο
Gegenteil	αντίθετο
Gegenwart	παρόν
Gegenwert	αντίτιμο
Gegenwort	αντώνυμο
Gegner	αντίπαλος
Gehalt	μισθός
Gehaltserhöhung	αύξηση μισθού
Geheimdienst	μυστική υπηρεσία
Geheimnis	μυστικό
Gehirn	εγκέφαλος
Gehirnerschütterung	διάσειση
Gehirnwäsche	πλύση εγκεφάλου
Gehorsam	υπακοή
Gehsteig	πεζοδρόμιο
Gehstraße	πεζόδρομος
Gehör	ακρόαση
Geier	γύπας
Geige	βιολί
Geiger	βιολιστής
Geisel	όμηρος
Geisha	γκέισα
Geist	πνεύμα
Geisterstadt	πόλη-φάντασμα
Geiz	τσιγγουνιά
Geiß	κατσίκα
Gel	γέλη
Gelatine	ζελατίνη
Gelb	κίτρινος
Gelbes Meer	Κίτρινη Θάλασσα
Geld	χρήματα
Geldautomat	ΑΤΜ
Geldgeschenk	δωρεά
Geldverächter	Άγιοι Ανάργυροι
Gelegenheit	ευκαιρία
Gelegenheit macht Diebe	η ευκαιρία κάνει τον κλέφτη
Gelenk	άρθρωση
Gelsenkirchen	Γκελζενκίρχεν
Geländer	κάγκελα
Gemahlin	σύζυγος
Gemisch	μίγμα
Gemälde	πίνακας
Gemüse	λαχανικό
Gemüseladen	λαχανοπωλείο
Gen	γονίδιο
Genealogie	γενεαλογία
General	στρατηγός
Genesis	Γένεσις
Genetik	γενετική
Genf	Γενεύη
Genfer See	Λίμνη της Γενεύης
Genfersee	Λίμνη της Γενεύης
Genick	αυχένας
Genitiv	γενική
Genom	γονιδίωμα
Genosse	σύντροφος
Genozid	γενοκτονία
Gent	Γάνδη
Genua	Γένοβα
Genus	γένος
Geodäsie	γεωδαισία
Geographie	γεωγραφία
Geologe	γεωλόγος
Geologie	γεωλογία
Geometrie	γεωμετρία
Georg	Γεώργιος
Georgien	Γεωργία
Georgier	Γεωργιανός
Georgisch	Γεωργιανά
Gepard	γατόπαρδος
Gepäck	αποσκευές
Gepäckband	καρουζέλ αποσκευών
Gerber	βυρσοδέψης
Gerechtigkeit	δικαιοσύνη
Gerfalke	ασπρογέρακας
Gerhard	Γεράρδος
Gericht	δικαστήριο
Gerichtsurteil	δικαστική απόφαση
Gerichtsverhandlung	δίκη
Germanium	γερμάνιο
Gerontokratie	γεροντοκρατία
Gerste	κριθάρι
Geruch	μυρωδιά
Geruchsbelastung	οσμορύπανση
Geruchsemission	έκλυση οσμής
Geruchsnerv	οσφραντικό νεύρο
Geruchssinn	όσφρηση
Geruchsstoff	οσμηρή ουσία
Geruchstest	δοκιμή οσμής
Gerundium	γερούνδιο
Gerundivum	γερουνδιακό
Gerät	συσκευή
Geräusch	θόρυβος
Gerücht	φήμη
Gesang	τραγούδισμα
Geschehen	γεγονός
Geschenk	δώρο
Geschichte	ιστορία
Geschichtsschreiber	ιστοριογράφος
Geschichtsschreibung	ιστοριογραφία
Geschick	δεξιοτεχνία
Geschicklichkeit	επιδεξιότητα
Geschirr	πιατικά
Geschirrspülmaschine	πλυντήριο
Geschirrtuch	πετσέτα
Geschlecht	φύλο
Geschlechtshormon	γεννητική ορμόνη
Geschlechtsorgan	γεννητικό όργανο
Geschlechtsverkehr	συνουσία
Geschlechtswort	άρθρο
Geschmack	γεύση
Geschmeidigkeit	ελαστικότητα
Geschwindigkeit	ταχύτητα
Geschwister	αδέλφια
Geschwätz	φλυαρία
Geschwür	έλκος
Geschäft	συναλλαγή
Geschäftspartner	συνέταιρος
Geschäftsviertel	εμπορικό κέντρο
Gesellschaft	κοινωνία
Gesellschaftsschicht	στρώμα
Gesetz	νόμος
Gesetzentwurf	νομοσχέδιο
Gesicht	πρόσωπο
Gesichtsvisier	ασπίδα προσώπου
Gespenst	φάντασμα
Gespräch	συζήτηση
Geste	χειρονομία
Gestein	πέτρωμα
Gestik	χειρονομώ
Gesundheit	γείτσες
Gesundheit	υγεία
Gesundheitswesen	δημόσιος
Gesäßtasche	κωλοτσέπη
Getreide	δημητριακά
Getreidemühle	αλευρόμυλος
Getreidesense	κόσα
Getriebe	κιβώτιο ταχυτήτων
Getränk	ποτό
Getränkeautomat	αυτόματος πωλητής ποτών
Getränkemarkt	κάβα
Getto	γκέτο
Getue	καμώματα
Geviertstrich	διπλή παύλα
Gewalt	βία
Gewalttat	βιαιοπραγία
Gewalttätigkeit	βιαιοπραγία
Gewebe	ύφασμα
Gewehr	τουφέκι
Gewerkschaft	συνδικάτο
Gewicht	βάρος
Gewichtheben	άρση βαρών
Gewinn	κέρδος
Gewinner	νικητής
Gewissen	συνείδηση
Gewitter	καταιγίδα
Gewohnheit	συνήθεια
Gewächshaus	θερμοκήπιο
Gewährung	παροχή
Gewölbe	θόλος
Gewürz	μπαχαρικό
Gewürznelke	γαρίφαλο
Geysir	θερμοπίδακας
Ghana	Γκάνα
Gibbon	γίββων
Gibraltar	Γιβραλτάρ
Gicht	ουρική αρθρίτιδα
Gießen	χύσιμο
Gießerei	χυτήριο
Gießkanne	ποτιστήρι
Gift	δηλητήριο
Giftgas	τοξικό αέριο
Gigabyte	γιγαδυφιοσυλλαβή
Gigant	γίγαντας
Gin	τζιν
Gipfel	κορυφή
Gipfeltreffen	σύνοδος κορυφής
Gips	γύψος
Gipsabdruck	εκμαγείο
Giraffe	καμηλοπάρδαλη
Girlande	γιρλάντα
Gischt	αφρός
Gitarre	κιθάρα
Gladiole	γλαδιόλα
Glas	γυαλί
Glasbläser	υαλοποιός
Glaser	τζαμάς
Glasgefäß	δοχείο
Glasgow	Γλασκώβη
Glasmacher	υαλοποιός
Glasscheibe	τζάμι
Glasur	σμάλτο
Glatze	φαλάκρα
Glaube	πίστη
Glaubwürdigkeit	αξιοπιστία
Gleichgewicht	ισορροπία
Gleichgültigkeit	αδιαφορία
Gleichheit	ισότητα
Gleichnis	παραβολή
Gleichstrom	συνεχές ρεύμα
Gleichung	εξίσωση
Gletscher	παγετώνας
Glied	μέλος
Glioblastom	γλοιοβλάστωμα
Globalisierung	παγκοσμιοποίηση
Globetrotter	κοσμογυρισμένος
Globus	υδρόγειος σφαίρα
Glocke	καμπάνα
Glossar	γλωσσάριο
Glottis	γλωσσίδα
Gluten	γλουταμίνη
Glycin	γλυκίνη
Glykolyse	γλυκόλυση
Glyphe	γλύφος
Glück	τύχη
Glücksbringer	γούρι
Glücksburg	Γκλύξμπουργκ
Glückwunsch	συγχαρητήρια
Glühbirne	λάμπα
Glühwürmchen	πυγολαμπίδα
GmbH	ΕΠΕ
Gnade	χάρη
Gnu	γκνου
Gold	χρυσός
Goldfisch	χρυσόψαρο
Goldgräber	χρυσοθήρας
Goldmedaille	χρυσό μετάλλιο
Golf	γκολφ
Golf von Bengalen	Κόλπος της Βεγγάλης
Golf von Mexiko	κόλπος του Μεξικού
Golgi-Apparat	συσκευή Golgi
Gondel	γόνδολα
Gong	γκονγκ
Goniometer	γωνιόμετρο
Goofy	Γκούφη
Gorilla	γορίλας
Gote	Γότθος
Gotland	Γκότλαντ
Gott	Θεός
Gott sei Dank	δόξα τω Θεώ
Gottesdienst	εκκλησιαστική λειτουργία
Gotteslästerung	βλασφημία
Gottfried	Γοδεφρείδος
Gourmet	γκουρμέ
Gouverneur	κυβερνήτης
Grab	τάφος
Grabrede	επικήδειος
Grabstein	ταφόπετρα
Grabstichel	Γλυφείον
Grad	βαθμός
Grad	βαθμός
Graf	κόμης
Graf	κόμης
Grafiker	γραφίστας
Grafschaft	κομητεία
Gram	θλίψη
Gramm	γραμμάριο
Grammatik	γραμματική
Gran Canaria	Γκραν Κανάρια
Granatapfel	ρόδι
Granate	χειροβομβίδα
Granit	γρανίτης
Granne	αθέρας
Grapefruit	γκρέιπφρουτ
Graphem	γράφημα
Graphit	γραφίτης
Gras	χόρτο
Grasnarbe	γρασίδι
Grassense	κόσα
Gratulation	ευχή
Graubünden	Γκράουμπυντεν
Graureiher	σταχτοτσικνιάς
Graveur	χαράκτης
Gravitation	βαρύτητα
Gravitationswelle	κύμα
Graviton	βαρυτόνιο
Graz	Γκρατς
Grazie	χάρη
Gregor	Γρηγόριος
Greif	γρύπας
Greis	γέροντας
Gremium	επιτελείο
Grenada	Γρενάδα
Grenoble	Γκρενόμπλ
Grenze	σύνορα
Grieche	Έλληνας
Griechenland	Ελλάδα
Griechin	Ελληνίδα
Griechisch	ελληνικά
Grieß	σιμιγδάλι
Griffel	κοντύλι
Griko	Γκρίκο
Grille	γρύλος
Grimasse	μορφασμός
Grind	κακάδι
Grippe	γρίπη
Groschen	γρόσι
Grotte	σπήλαιο
Großbritannien	Μεγάλη Βρετανία
Großbuchstabe	κεφαλαίο
Großer Bär	Μεγάλη Άρκτος
Großglockner	Γκροσγκλόκνερ
Großhandel	χοντρεμπόριο
Großherzogtum Luxemburg	Μέγα Δουκάτο του Λουξεμβούργου
Großjährigkeit	ενηλικότητα
Großmutter	γιαγιά
Großneffe	μικρανεψιός
Großnichte	μικρανεψιά
Großserbien	Μεγάλη Σερβία
Großstadt	μεγαλούπολη
Großstädter	κάτοικος
Großstädterin	κάτοικος
Großvater	παππούς
Grube	λάκκος
Grund	λόγος
Grundfarbe	χρώμα
Grundfläche	βάση
Grundschule	δημοτικό
Grundstück	ακίνητο
Grundwasser	υπόγεια ύδατα
Gruppe	ομάδα
Gruppensex	παρτούζα
Gruyère	γραβιέρα
Gruß	χαιρετισμός
Gräfin	κόμισσα
Gräte	ψαροκόκκαλο
Grönland	Γροιλανδία
Grönlandhai	καρχαρίας της Γροιλανδίας
Grönländer	Γροιλανδός
Größenwahn	μεγαλομανία
Gründer	ιδρυτής
Gründling	γυφτόψαρο
Gründonnerstag	Μεγάλη Πέμπτη
Gründung	ίδρυση
Gründungsjahr	ίδρυση
Grünfink	φλώρος
Guadeloupe	Γουαδελούπη
Guam	Γκουάμ
Guatemala	Γουατεμάλα
Guillotine	γκιλοτίνα
Guinea	Γουινέα
Guinea-Bissau	Γουινέα-Μπισσάου
Gummi	λάστιχο
Gurke	αγγούρι
Guru	γκουρού
Gusseisen	χυτοσίδηρος
Guyana	Γουιάνα
Gymnasium	γυμνάσιο
Gynäkologe	γυναικολόγος
Gynäkologie	γυναικολογία
Gynäkomastie	γυναικομαστία
Gyros	γύρος
Gyros Pita	γυρος πιτα
Gämse	αγριόγιδο
Gänseblümchen	μαργαρίτα
Gänsehaut	ανατριχίλα
Gärtner	κηπουρός
Göteborg	Γκέτεμποργκ
Göttin	θεά
Göttingen	Γκέττινγκεν
Gültigkeit	εγκυρότητα
Günstlingswirtschaft	ευνοιοκρατία
Gürtel	ζώνη
Haar	τρίχα
Haarnadel	φουρκέτα
Haarstern	κομήτης
Haarsträhne	μες
Habakuk	Αββακούμ
Habgier	απληστία
Habicht	διπλοσάινο
Habsucht	απληστία
Hackbrett	σαντούρι
Hacke	τσάπα
Hacker	χάκερ
Hades	Άδης
Hadith	χαντίθ
Hadron	αδρόνιο
Hafen	λιμάνι
Hafer	βρώμη
Haferflocke	νιφάδα
Hafnium	άφνιο
Haftbefehl	ένταλμα σύλληψης
Hagel	χαλάζι
Haggai	Αγγαίος
Hagiografie	αγιολογία
Hahn	κόκορας
Hai	καρχαρίας
Haiku	χαϊκού
Hainbuche	γάβρος
Haiti	Αϊτή
Haken	γάντζος
Halbinsel	χερσόνησος
Halbjahr	εξάμηνο
Halbkreis	ημικύκλιο
Halbleiter	ημιαγωγός
Halbmond	μισοφέγγαρο
Halfter	θήκη
Halle	αίθουσα
Halleluja	Αλληλούια
Halogen	αλογόνο
Hals	λαιμός
Hals- und Beinbruch	καλή τύχη
Hals-Nasen-Ohren-Arzt	ωτορινολαρυγγολόγος
Halsschmerz	πονόλαιμος
Halsweh	λαιμά
Haltestelle	stási
Haltung	στάση
Hamam	χαμάμ
Hamburg	Αμβούργο
Hamburger	χάμπουργκερ
Hammer	σφυρί
Hammer und Sichel	σφυροδρέπανο
Hamster	χάμστερ
Hand	χέρι
Handarbeit	χειροτεχνία
Handball	χάντμπολ
Handball	χάντμπολ
Handbremse	χειρόφρενο
Handbuch	εγχειρίδιο
Handel	εμπόριο
Handeln	δράση
Handelsniederlassung	εμπορικός
Handelsschiff	εμπορικό πλοίο
Handelsverbot	απαγόρευση εμπορίας
Handgelenk	καρπός
Handicap	χάντικαπ
Handrührgerät	μίξερ
Handschuh	γάντι
Handtuch	πετσέτα
Handvoll	χούφτα
Handwerker	βιοτέχνης
Handwerkszeug	εργαλεία
Handy	κινητό
Hanf	κάνναβη
Hangar	υπόστεγο
Hannibal	Αννίβας
Hannover	Αννόβερο
Hanoi	Ανόι
Hans	Γιάννης
Hantel	αλτήρας
Harem	χαρέμι
Harfe	άρπα
Harmonie	αρμονία
Harn	ούρα
Harnleiter	ουρητήρας
Harnröhre	ουρήθρα
Harpune	καμάκι
Harpyie	άρπυια
Hartkäse	τυρί
Hartnäckigkeit	επιμονή
Hartung	Ιανουάριος
Hartweizen	σιτάρι
Harz	ρετσίνι
Haschemitisches Königreich Jordanien	Χασεμιτικό Βασίλειο της Ιορδανίας
Haschischzigarette	τσιγαριλίκι
Hase	Χάζε
Hase	λαγός
Haselmaus	δασομυωξός
Haselnuss	φουντούκι
Hass	μίσος
Hassium	χάσιο
Hattrick	χατ τρικ
Haubitze	οβιδοβόλο
Haupt-	βασικός
Hauptgericht	κύριο πιάτο
Hauptquartier	αρχηγείο
Hauptseite	Κύρια Σελίδα
Hauptstadt	πρωτεύουσα
Hauptwort	ουσιαστικό
Haus	σπίτι
Hausaufgabe	άσκηση
Hausfrau	νοικοκυρά
Haushalt	προϋπολογισμός
Hausherrin	οικοδέσποινα
Hausschuh	παντόφλα
Haustier	κατοικίδιο ζώο
Haut	δέρμα
Hautausschlag	εξάνθημα
Havanna	Αβάνα
Havarie	αβαρία
Havel	Χάβελ
Hawaii	Χαβάη
Hebamme	μαία
Hebe	Ήβη
Hebraismus	εβραϊσμός
Hebriden	Εβρίδες
Hecht	τούρνα
Hecke	φράχτης
Hedoniker	ηδονιστής
Heer	στρατός
Heeresspital	νοσοκομείο
Hefe	μαγιά
Hefezopf	τσουρέκι
Heft	τετράδιο
Hegelianismus	Εγελιανισμός
Heide	άπιστος
Heidelbeere	μπλε μουρο
Heidelberg	Χαϊδελβέργη
Heilbutt	ιππόγλωσσα
Heiligabend	Παραμονή Χριστουγέννων
Heilige	αγία
Heiligenbild	αγιογραφία
Heiliger	άγιος
Heiliger Geist	Άγιο Πνεύμα
Heiliger Stuhl	Αγία Έδρα
Heiliges Römisches Reich Deutscher Nation	Αγία Ρωμαϊκή Αυτοκρατορία
Heilkraut	αγριοβότανο
Heimat	πατρίδα
Heimkehr	επιστροφή
Heimsuchung	μάστιγα
Heimweh	νοσταλγία
Heirat	γάμος
Heizkörper	καλοριφέρ
Heizung	καλοριφέρ
Heizungstechnik	θέρμανση
Hektar	εκτάριο
Held	ήρωας
Helene	Ελένη
Helferlein	Γλόμπος
Helgoland	Χέλγκολαντ
Helium	ήλιο
Hellenische Republik	Ελληνική Δημοκρατία
Hellespont	Ελλήσποντος
Helm	κράνος
Helot	είλωτας
Helsinki	Ελσίνκι
Hemd	πουκάμισο
Hengst	επιβήτορας
Henker	δήμιος
Henna	χένα
Heptagon	επτάγωνο
Hera	Ήρα
Heraion	Ηραίον
Heraldik	εραλδική
Herausforderung	πρόκληση
Herberge	ξενώνας
Herbizid	ζιζανιοκτόνο
Herbst	φθινόπωρο
Herd	κουζίνα
Herdenimmunität	ανοσία αγέλης
Hering	ρέγγα
Herkules	Ηρακλής
Herkunft	καταγωγή
Hermelin	ερμίνα
Heroin	ηρωίνη
Herostrat	Ηρόστρατος
Herr	κύριος
Herrchen	κύριος
Herrscher	ηγεμόνας
Herrscherhaus	δυναστεία
Hersteller	κατασκευαστής
Hertz	χερτζ
Herz	καρδιά
Herzlichkeit	εγκαρδιότητα
Herzog	δούκας
Herzogin	δούκισσα
Herzogtum	δουκάτο
Hessen	Έσση
Heu	ξηρόχορτο
Heurolle	μπάλα από άχυρο
Hexadezimalsystem	δεκαεξαδικό
Hexe	μάγισσα
Hexenschuss	οσφυαλγία
Hierarchie	ιεραρχία
Hieroglyphe	ιερογλυφικά
Hieronymus	Ιερώνυμος
Hilfe	βοήθεια
Hilfsschiff	βοηθητικό πλοίο
Himbeere	σμεουριά
Himmel	ουρανός
Himmelreich	βασιλεία
Himmelskörper	ουράνιο σώμα
Himmelsäquator	ουράνιος ισημερινός
Hin und Her	πηγαινέλα
Hindi	Χίντι
Hinduismus	ινδουισμός
Hindukusch	Χίντου Κους
Hinrichtung	εκτέλεση
Hinterhalt	ενέδρα
Hinweis	συμβουλή
Hiobsbotschaft	άσχημος
Hippodrom	ιπποδρόμιο
Hiragana	χιραγκάνα
Hirngespinst	χίμαιρα
Hirnhautentzündung	μηνιγγίτιδα
Hirsch	ελάφι
Hirschkuh	ελαφίνα
Hirse	κεχρί
Hirte	βοσκός
Hisbollah	Χεζμπολάχ
Histologie	ιστολογία
Historie	ιστορία
Historiker	ιστορικός
Hitler	Χίτλερ
Hitze	ζέστη
Hobby	χόμπι
Hobel	πλάνη
Hochhaus	πολυκατοικία
Hochmut	υπεροψία
Hochofen	υψικάμινος
Hochparterre	ισόγειο
Hochwasser	πλημμύρα
Hockey	χόκεϊ
Hoden	όρχις
Hodensack	όσχεο
Hof	αυλή
Hoffnung	ελπίδα
Holland	Ολλανδία
Hollywood	Χόλυγουντ
Holmium	όλμιο
Holocaust	ολοκαύτωμα
Holocaust	Ολοκαύτωμα
Hologramm	ολόγραμμα
Holstein	Χόλσταϊν
Holunder	σαμπούκος
Holz	ξύλο
Holzblasinstrument	όργανο καλάμων
Holzkohle	ξυλοκάρβουνο
Homer	Όμηρος
Homilie	κήρυγμα
Homonym	ομώνυμο
Homophobie	ομοφοβία
Homosexualität	ομοφυλοφιλία
Homöopathie	ομοιοπαθητική
Homöostase	ομοιόσταση
Homöostasis	ομοιόσταση
Honduras	Ονδούρα
Hongkong	Χονγκ Κονγκ
Honig	μέλι
Honigkuchen	μελόπιτα
Honigmelone	πεπόνι
Honorar	αμοιβή
Hopfen	λυκίσκος
Hoplit	οπλίτης
Horde	ορδή
Horizont	ορίζοντας
Hormon	ορμόνη
Hornisse	μεγάλη σφήκα
Hornung	Φεβρουάριος
Horoskop	ωροσκόπιο
Hose	παντελόνι
Hosea	Ωσηέ
Hosenbein	μπατζάκι
Hosentasche	τσέπη
Hostel	ξενώνας
Hotel	ξενοδοχείο
Hubschrauber	ελικόπτερο
Hubschrauberlandeplatz	ελικοδρόμιο
Huf	οπλή
Hufeisen	πέταλο
Huhn	κότα
Humanismus	ανθρωπισμός
Hummel	βομβίνος
Hummer	αστακός
Hummus	χούμους
Humor	χιούμορ
Humus	χούμος
Hund	σκύλος
Hunde, die bellen, beißen nicht	σκύλος που γαβγίζει δε δαγκώνει
Hundeleine	λουρί
Hundertstel	ένα εκατοστό
Hunger	πείνα
Hungersnot	λιμός
Hupe	κλάξον
Hure	πουτάνα
Hurrikan	θύελλα
Husar	ουσάρος
Husten	βήχας
Hut	καπέλο
Hutzel	κουκουνάρα
Hyazinthe	υάκινθος
Hybris	ύβρις
Hydrokortison	υδροκορτιζόνη
Hydrologie	υδρολογία
Hydrolyse	υδρόλυση
Hygiene	υγιεινή
Hypertonie	υπέρταση
Hypnose	ύπνωση
Hyponym	υπώνυμο
Hypotenuse	υποτείνουσα
Hypotonie	υποτονία
Hypoventilation	υποαερισμός
Hysterie	υστερία
Hyäne	ύαινα
Häftling	κρατούμενος
Häher	κίσσα
Hähnchen	κοτόπουλο
Hähnchenbrust	στήθος κοτόπουλου
Hähnchenflügel	φτερούγα κοτόπουλου
Hähnchenschenkel	μπούτι κοτόπουλου
Hälfte	μισό
Händler	έμπορος
Händlerin	εμπόρισσα
Hängebrücke	κρεμαστή γέφυρα
Hängematte	αιώρα
Häschen	λαγουδάκι
Höflichkeit	ευγένεια
Höhe	ύψος
Höhle	σπήλαιο
Höhlenforscher	σπηλαιολόγος
Hölle	κόλαση
Hörbuch	ηχητικό
Hüfte	ισχίο
Hügel	λόφος
Hühnerbein	τύμπανα κοτόπουλου
Hühnerstall	κοτέτσι
Hülsenfrucht	όσπριο
Hündin	σκύλα
Hütte	καλύβα
IP-Adresse	διεύθυνση IP
IWF	ΔΝΤ
Iberer	Ίβηρες
Ibis	ίβις
Ich	εγώ
Ichthyologie	ιχθυολογία
Idaho	Αϊντάχο
Ideal	ιδεώδες
Idealismus	ιδεαλισμός
Idee	ιδέα
Idefix	Ιντεφίξ
Identität	ταυτότητα
Ideologie	ιδεολογία
Idiom	ιδίωμα
Idiosynkrasie	ιδιοσυγκρασία
Idiot	ηλίθιος
Ido	ίντο
Igel	σκαντζόχοιρος
Ijob	Ιώβ
Ikone	εικόνα
Illinois	Ιλινόι
Illyrien	Ιλλυρία
Iltis	βρωμοκούναβο
Imam	ιμάμης
Imker	μελισσοκόμος
Immigrant	μετανάστης
Immobilie	ακίνητο
Immunologie	ανοσολογία
Impedanz	εμπέδηση
Imperativ	προστακτική
Imperialismus	ιμπεριαλισμός
Imperium Romanum	Ρωμαϊκή Αυτοκρατορία
Impfausweis	βιβλιάριο εμβολίων
Impfpass	βιβλιάριο εμβολίων
Impfstoff	εμβόλιο
Impfung	εμβολιασμός
Import	εισαγωγή
Impressionist	ιμπρεσιονιστής
Inder	Ινδός
Indiana	Ιντιάνα
Indianer	Ινδιάνος
Indianerin	Ινδιάνα
Indien	Ινδία
Indischer Ozean	Ινδικός Ωκεανός
Indium	ίνδιο
Individualist	ατομιστής
Individuum	άτομο
Indoktrination	κατήχηση
Indonesien	Ινδονησία
Indossament	οπισθογράφηση
Indus	Ινδός
Industrie	βιομηχανία
Industrieller	εργοστασιάρχης
Infant	ινφάντης
Infanterie	πεζικό
Infarkt	έμφραγμα
Infekt	λοίμωξη
Infektion	λοίμωξη
Infinitiv	απαρέμφατο
Infinitivsatz	απαρεμφατική πρόταση
Inflation	πληθωρισμός
Informatik	πληροφορική
Information	πληροφορία
Ingenieur	μηχανικός
Ingolstadt	Ίνγκολστατ
Ingwer	ζιγγίβερι
Inhalt	περιεχόμενο
Initiative	πρωτοβουλία
Injektion	ένεση
Inline-Skate	Tροχοπέδιλο
Innenhof	αυλή
Innerei	εντόσθια
Innsbruck	Ίνσμπρουκ
Inquisition	Ιερά Εξέταση
Insasse	επιβάτης
Insekt	έντομο
Insel	νησί
Insel Man	Νήσος Μαν
Inselgruppe	συστάδα
Inspiration	έμπνευση
Instinkt	ένστικτο
Institut	ινστιτούτο
Institution	ίδρυμα
Insulin	ινσουλίνη
Integral	ολοκλήρωμα
Intelligenz	ευφυΐα
Intelligenzquotient	δείκτης νοημοσύνης
Intelligenztest	τεστ νοημοσύνης
Intensivstation	εντατικός
Intention	πρόθεση
Interaktion	αλληλεπίδραση
Interesse	ενδιαφέρον
Interimsschein	προσωρινός τίτλος
Interjektion	επιφώνημα
Internat	οικοτροφείο
Internationales Phonetisches Alphabet	ΔΦΑ
Internet	διαδίκτυο
Interrogativpronomen	ερωτηματική
Interview	συνέντευξη
Inthronisation	ενθρόνιση
Inversionswetterlage	ατμοσφαιρική αναστροφή
Investition	επένδυση
Investor	επενδυτής
Inzest	αιμομιξία
Ion	ιόν
Ionenkonzentration	συγκέντρωση
Ionisation	ιονισμός
Ionisationsröhre	ιοντισμό σωλήνα
Ionisator	ιονιστής
Ionisches Meer	Ιόνιο πέλαγος
Ionisierung	ιονισμός
Ionosphäre	ιονόσφαιρα
Iota	γιώτα
Irak	Ιράκ
Iran	Ιράν
Iraner	Ιρανός
Ire	Ιρλανδός
Irene	Ειρήνη
Iridium	ιρίδιο
Irin	Ιρλανδή
Iris	ίριδα
Irisch	ιρλανδικά
Irland	Ιρλανδία
Ironie	ειρωνία
Irrstern	κομήτης
Isar	Ίζαρ
Islam	ισλαμισμός
Islamische Republik Afghanistan	Ισλαμικό κράτος του Αφγανιστάν
Islamische Republik Iran	Ισλαμική Δημοκρατία του Ιράν
Island	Ισλανδία
Isländisch	Ισλανδικά
Isoglosse	ισόγλωσσο
Isolde	Ιζόλδη
Isolierflasche	κανάτα θερμός
Isolierkanne	κανάτα θερμός
Isotherme	ισόθερμος
Isotop	ισότοπο
Israel	Ισραήλ
Israel-Libanon-Konflikt	Διαμάχη Ισραήλ-Λιβάνου
Israeli	Ισραηλινός
Istanbul	Κωνσταντινούπολη
Italien	Ιταλία
Italiener	Ιταλός
Italienerin	Ιταλίδα
Italienisch	ιταλικά
Italienische Republik	Ιταλική Δημοκρατία
Ithaka	Ιθάκη
Jacke	ζακέτα
Jade	νεφρίτης
Jagd	κυνήγι
Jaguar	ιαγουάρος
Jahr	χρόνος
Jahrestag	επέτειος
Jahreszeit	εποχή
Jahrfünft	πενταετία
Jahrhundert	αιώνας
Jahrtausend	χιλιετία
Jahrzehnt	δεκαετία
Jahwe	Γιαχβέ
Jakarta	Τζακάρτα
Jakob	Ιάκωβος
Jakobsmuschel	χτένι
Jakobus	Ιάκοβος
Jamaika	Τζαμάικα
Jan Mayen	Γιαν Μαγιέν
Janus	Ιανός
Japan	Ιαπωνία
Japaner	Ιάπωνας
Japanisch	Ιαπωνικά
Jargon	αργκό
Java	Ιάβα
Jazz	τζαζ
Jemen	Υεμένη
Jena	Ιένα
Jeremia	Ιερεμίας
Jerewan	Γερεβάν
Jerusalem	Ιερουσαλήμ
Jesaja	Ησαΐας
Jesus	Ιησούς
Jesus Christus	Ιησούς Χριστός
Jiddisch	γίντις
Job	δουλειά
Joch	ζυγός
Jochbein	ζυγωματικό
Jod	ιώδιο
Joel	Ιωήλ
Joghurt	γιαούρτι
Johann	Γιάννης
Johanna	Ιωάννα
Johannes	Ιωάννης
Johannisbeere	φραγκοστάφυλο
Johannisbrotbaum	χαρουπιά
Joint	τσιγαριλίκι
Jonas	Ιωνάς
Jordanien	Ιορδανία
Josef	Ιωσήφ
Josua	Ιησούς
Joule	τζάουλ
Journalismus	δημοσιογραφία
Journalist	δημοσιογράφος
Juba	Τζούμπα
Jubiläum	επέτειος
Juckreiz	κνησμός
Judas	Ιούδας
Judaskuss	φιλί του Ιούδα
Jude	Εβραίος
Judenhass	αντισημιτισμός
Judentum	ιουδαϊσμός
Judo	τζούντο
Judäa	Ιουδαία
Jugend	νεολαία
Jugendherberge	ξενώνας νεότητας
Jugendliche	έφηβη
Jugendlicher	έφηβος
Jugendstil	Αρ Νουβό
Jugoslawe	Γιουγκοσλάβος
Jugoslawien	Γιουγκοσλαβία
Julia	Ιουλία
Julius	Ιούλιος
Junge	αγόρι
Junges	μικρό
Jungfrau	παρθένα
Jungfräulichkeit	παρθενιά
Junggeselle	εργένης
Jungsteinzeit	νεολιθική
Jupiter	Δίας
Jura	Ιουράς
Jurist	νομικός
Justizministerium	υπουργείο δικαιοσύνης
Juwelier	κοσμηματοπώλης
Jäger	κυνηγός
Jüdin	Ιουδαία
Jünger	μαθητής
Jütland	Γιουτλάνδη
Kabel	καλώδιο
Kabeljau	βακαλάος
Kabul	Καμπούλ
Kadaver	κουφάρι
Kaffee	καφές
Kaffee	καφές
Kaffeekanne	μπρίκι
Kaffeemaschine	καφετιέρα
Kai	αποβάθρα
Kairo	Κάιρο
Kaiser	αυτοκράτορας
Kaisergranat	καραβίδα
Kaiserin	αυτοκράτειρα
Kaiserreich	αυτοκρατορία
Kaiserschnitt	καισαρική τομή
Kaiserslautern	Καϊζερσλάουτερν
Kajak	καγιάκ
Kakadu	κακατόης
Kakao	κακάο
Kakerlake	κατσαρίδα
Kakophonie	κακοφωνία
Kaktus	κάκτος
Kalabrien	Καλαβρία
Kalb	μοσχάρι
Kaleidoskop	καλειδοσκόπιο
Kalender	ημερολόγιο
Kaliber	διαμέτρημα
Kalifornien	Καλιφόρνια
Kalium	κάλιο
Kalkstein	ασβεστόλιθος
Kalkutta	Καλκούτα
Kalligraph	καλλιγράφος
Kalmar	καλαμάρι
Kalorie	θερμίδα
Kalter Krieg	Ψυχρός Πόλεμος
Kaltplasma	ψυχρό πλάσμα
Kambodscha	Καμπότζη
Kamee	καμέα
Kamel	καμήλα
Kamelie	καμέλια
Kamera	φωτογραφική μηχανή
Kamerun	Καμερούν
Kamille	χαμομήλι
Kamillentee	χαμομήλι
Kamin	τζάκι
Kamm	χτένα
Kampanien	Καμπανία
Kampf	αγώνας
Kampfer	καμφορά
Kampfläufer	ψευτομαχητής
Kanaan	Χαναάν
Kanaan	Χαναάν
Kanada	Καναδάς
Kanadier	Καναδός
Kanadierin	Καναδή
Kanal	κανάλι
Kanapee	καναπές
Kanarienvogel	καναρίνι
Kanarische Inseln	Κανάριες Νήσοι
Kandahar	Κανταχάρ
Kandidat	υποψήφιος
Kaninchen	κουνέλι
Kanister	μπιτόνι
Kannibalismus	κανιβαλισμός
Kanone	κανόνι
Kansas	Κάνσας
Kansas City	Κάνσας Σίτυ
Kantianer	καντιανός
Kantine	καντίνα
Kanzel	άμβωνας
Kaolin	καολίνης
Kap	ακρωτήρι
Kap Verde	Πράσινο Ακρωτήριο
Kapelle	παρεκκλήσι
Kaper	kάππαρη
Kapital	κεφάλαιο
Kapitalismus	καπιταλισμός
Kapitalist	κεφαλαιοκράτης
Kapitel	κεφάλαιο
Kapitell	κιονόκρανο
Kapitulation	συνθηκολόγηση
Kapitän	πλοίαρχος
Kappadokien	Καππαδοκία
Kapuze	κουκούλα
Karabiner	καραμπίνα
Karamell	καραμέλα
Karaoke	καραόκε
Karate	καράτε
Karavelle	καραβέλα
Karawane	καραβάνι
Kardamom	κάρδαμο
Kardinal	καρδινάλιος
Kardiologe	καρδιολόγος
Kardiologie	καρδιολογία
Karelien	Καρελία
Karfreitag	Μεγάλη Παρασκευή
Karies	τερηδόνα
Karikatur	καρικατούρα
Karl	Κάρολος
Karlsruhe	Καρλσρούη
Karmin	καρμίνιο
Karneval	καρναβάλι
Karo	καρό
Karotte	καρότο
Karpaten	Καρπάθια Όρη
Karpfen	κυπρίνος
Karsamstag	Μεγάλο Σάββατο
Karte	χάρτης
Karteikarte	καρτέλλα
Kartenhaus	σπίτι από τραπουλόχαρτα
Karthago	Καρχηδόνα
Kartoffel	πατάτα
Kartoffelpüree	πουρές
Kartoffelsalat	πατατοσαλάτα
Karwoche	Μεγάλη Εβδομάδα
Karyatide	Καρυάτις
Karzinom	καρκίνωμα
Kasachstan	Καζακστάν
Kasan	Καζάν
Kasbah	κάσμπαχ
Kasein	καζεΐνη
Kaserne	στρατώνας
Kaspisches Meer	Κασπία Θάλασσα
Kasse	ταμείο
Kassel	Κάσσελ
Kastanie	καστανιά
Kasus	περιστατικό
Katakana	κατακάνα
Katakombe	κατακόμβη
Katalanisch	Καταλανικά
Katalog	κατάλογος
Katalonien	Καταλωνία
Katalysator	καταλύτης
Katamaran	καταμαράν
Katapult	καταπέλτης
Katar	Κατάρ
Katarrh	κατάρρους
Katastrophe	καταστροφή
Katechismus	κατήχηση
Kategorie	κατηγορία
Kater	γάτος
Katharevousa	καθαρεύουσα
Katharina	Αικατερίνη
Kathedrale	μητρόπολη
Kathete	κάθετος
Kathmandu	Κατμαντού
Kathode	κάθοδος
Katholizismus	καθολικισμός
Kation	κατιόν
Katze	γάτα
Kauderwelsch	αλαμπουρνέζικα
Kauf	αγορά
Kauffahrer	εμπορικό πλοίο
Kauffrau	εμπόρισσα
Kaufhaus	πολυκατάστημα
Kaufmann	έμπορος
Kaugummi	τσίχλα
Kaukasus	Καύκασος
Kaulquappe	γυρίνος
Kausalität	αιτιότητα
Kaution	εγγύηση
Kavallerie	ιππικό
Kaviar	χαβιάρι
Kegel	κώνος
Kegeln	μπόουλινγκ
Kehlkopf	λάρυγγας
Kehricht	σκουπίδια
Keil	σφήνα
Keilschrift	σφηνοειδής γραφή
Keimbelastung	μικροβιακό φορτίο
Kelch	κάλυκας
Kelle	κουτάλα
Keller	κελάρι
Kellerfenster	φυσητήρας
Kellner	σερβιτόρος
Kellnerin	σερβιτόρα
Kelten	Κέλτες
Kenia	Κένυα
Kentucky	Κεντάκυ
Keramikgefäß	δοχείο
Keratin	κερατίνη
Kerbel	σκαντζίκι
Kern	πυρήνας
Kernholz	εγκάρδιο ξύλο
Kernkraft	πυρηνικός
Kerze	κερί
Ketchup	κέτσαπ
Keton	κετόνη
Kette	αλυσίδα
Kettensäge	αλυσοπρίονο
Ketzerei	αίρεση
Keuchhusten	κοκκύτης
Keule	ρόπαλο
Kevin	Κέβιν
Khartum	Χαρτούμ
Kibbuz	κιμπούτς
Kichererbse	ρεβιθιά
Kiefer	γνάθος
Kiefer	πεύκο
Kiel	Κίελο
Kieme	σπάραχνο
Kiew	Κίεβο
Kigali	Κιγκάλι
Killer	δολοφόνος
Kilobyte	κιλομπάιτ
Kilogramm	χιλιόγραμμο
Kilometer	χιλιόμετρο
Kimono	κιμονό
Kind	παιδί
Kinderarzt	παιδίατρος
Kindergarten	νηπιαγωγείο
Kindergärtner	νηπιαγωγός
Kindergärtnerin	νηπιαγωγός
Kinderwagen	καροτσάκι βρέφους
Kinderzimmer	παιδικό
Kindheit	παιδικός
Kinematik	κινηματική
Kinetik	κινητική
Kinn	πηγούνι
Kino	σινεμά
Kiosk	περίπτερο
Kirche	εκκλησία
Kirchspiel	παρόχια
Kirgisistan	Κιργιζία
Kiribati	Κιριμπάτι
Kirschbaum	κερασιά
Kirsche	κεράσι
Kissen	μαξιλάρι
Kiste	κιβώτιο
Kitsch	κιτς
Kitzel	γαργαλητό
Kiwi	ακτινίδιο
Kiwi	ακτινίδιο
Klagemauer	Δυτικό Τείχος
Klagenfurt	Κλάγκενφουρτ
Klammeraffe	παπάκι
Klappbett	πτυσσόμενο
Klapperschlange	κροταλίας
Klappstuhl	πτυσσόμενη
Klapptisch	πτυσσόμενος
Klarinette	κλαρινέτο
Klarinettist	κλαρινετίστας
Klasse	κατηγορία
Klassenkampf	πάλη των τάξεων
Klassifikation	ταξινόμηση
Klatschbase	κουτσομπόλα
Klausel	ρήτρα
Klausur	απομόνωση
Klavier	πιάνο
Klee	τριφύλλι
Kleiber	δενδροτσοπανάκος
Kleid	φόρεμα
Kleiderbügel	κρεμάστρα
Kleiderschrank	ντουλάπα
Kleidung	ρούχα
Kleidungsstück	ρούχo
Kleie	πίτουρο
Kleinarbeit	λεπτοδουλειά
Kleinasien	Μικρά Ασία
Kleinbuchstabe	γράμμα
Kleinstadt	κωμόπολη
Kleinwuchs	νανισμός
Klempner	υδραυλικός
Kleptokratie	κλεπτοκρατία
Kleptomane	κλεπτομανής
Klerus	κλήρος
Klick	κλικ
Klima	κλίμα
Klinge	λεπίδα
Klingel	κουδούνι
Klinik	κλινική
Klinikum	νοσοκομείο
Klitoris	κλειτορίδα
Klon	κλώνος
Klopapier	χαρτί υγείας
Klosettpapier	χαρτί υγείας
Kloster	μοναστήρι
Klugscheißer	εξυπνάκιας
Knie	γόνατο
Kniekehle	ιγνύα
Kniescheibe	επιγονατίδα
Knoblauch	σκόρδο
Knoblauchzehe	σκελίδα
Knochen	κόκαλο
Knochenmark	μυελός των οστών
Knopf	κουμπί
Knorpel	χόνδρος
Knoten	κόμπος
Knäuel	κουβάρι
Knöchel	αστράγαλος
Koala	κοάλα
Koalition	συνασπισμός
Kobalt	κοβάλτιο
Koblenz	Κόμπλεντς
Kobra	κόμπρα
Koch	μάγειρας
Kochlöffel	κουτάλα
Kodonostasion	κωδωνοστάσιο
Koeffizient	συντελεστής
Koffein	καφεΐνη
Koffer	βαλίτσα
Kofferraum	πορτμπαγκάζ
Kohl	λάχανο
Kohle	κάρβουνο
Kohlenhydrat	υδατάνθρακας
Kohlenstoff	άνθρακας
Kohlensäure	ανθρακικό οξύ
Kohlenwasserstoff	υδρογονάνθρακας
Kohleofen	σόμπα
Kohlmeise	καλόγερος
Kohlrabi	γογγυλοκράμβη
Koine	κοινή
Kojote	κογιότ
Kokain	κοκαΐνη
Kokosinseln	Νησιά Κόκος
Kokosnuss	ινδοκάρυδο
Kokospalme	κοκοφοίνικας
Kolben	έμβολο
Kolchos	κολχόζ
Kolibri	κολιμπρί
Kollege	συνάδελφος
Kollegin	συνάδελφος
Kolonialismus	αποικιοκρατία
Kolophonium	κολοφώνιο
Koloss	κολοσσός
Kolosser	Κολοσσαείς
Kolostrum	πρωτόγαλα
Kolumbien	Κολομβία
Koma	κόμη
Koma	κώμα
Komet	κομήτης
Komfortlüftung	αερισμός άνεσης
Komitologie	επιτροπολογία
Komma	κόμμα
Kommandant	διοικητής
Kommen und Gehen	πηγαινέλα
Kommentar	σχόλιο
Kommission	επιτροπή
Kommode	κομό
Kommunikation	επικοινωνία
Kommunismus	κομμουνισμός
Komoren	Κομόρες
Kompass	πυξίδα
Komplize	συνεργός
Komponist	συνθέτης
Kompositum	σύνθετο
Kompost	κοπρόχωμα
Komödie	κωμωδία
Kondensator	πυκνωτής
Konditor	ζαχαροπλάστης
Konditorei	ζαχαροπλαστείο
Kondom	προφυλακτικό
Konferenz	διάσκεψη
Konfession	θρήσκευμα
Konfetti	κομφετί
Konflikt	σύγκρουση
Kongo	Δημοκρατία του Κονγκό
Kongress	συνέδριο
Konjugation	κλίση
Konjunktion	σύνδεσμος
Konkordat	κονκορδάτο
Konkubine	παλλακίδα
Konkurs	πτώχευση
Konkursverwalter	πτώχευση
Konnotation	συνδήλωση
Konrad	Κόνραντ
Konsequenz	συνέπεια
Konserve	κονσέρβα
Konsonant	σύμφωνο
Konstante	σταθερά
Konstantin	Κωνσταντίνος
Konstantinopel	Κωνσταντινούπολη
Konsulat	προξενείο
Konsum	κατανάλωση
Kontakt	επαφή
Kontaktlinse	φακός επαφής
Kontamination	μόλυνση
Kontinent	ήπειρος
Konto	λογαριασμός
Kontrabass	κοντραμπάσο
Kontrapost	αντίρροπος
Kontrapunkt	αντίστιξη
Kontrolle	έλεγχος
Konzert	συναυλία
Konzertsaal	αίθουσα
Kooperation	συνεργασία
Koordinate	συντεταγμένη
Kopenhagen	Κοπεγχάγη
Kopf	κεφάλι
Kopf-an-Kopf-Rennen	αγώνας
Kopfgeldjäger	κυνηγός επικυρηγμένων
Kopfhörer	ακουστικό
Kopfschmerz	πονοκέφαλος
Kopfsprung	βουτιά
Kopfsteinpflaster	καλντερίμι
Kopftuch	μαντίλι
Kopie	αντίγραφο
Kopierpapier	χαρτί υγείας
Koppa	κόππα
Koralle	κοράλλι
Koran	Κοράνιο
Korb	καλάθι
Korea	Κορέα
Koreanisch	Κορεατικά
Korfiot	Κερκυραίος
Korfu	Κέρκυρα
Korinth	Κόρινθος
Kork	φελλός
Korkenzieher	τιρμπουσόν
Kormoran	κορμοράνος
Kornblume	κενταύριον
Kornelkirsche	κρανιά
Kornspeicher	σιταποθήκη
Korrespondent	ανταποκριτής
Korruption	διαφθορά
Korsika	Κορσική
Koryphäe	κορυφή
Koryphäe	κορυφή
Koseform	χαϊδευτικό
Kosmetik	αισθητική
Kosmologe	κοσμολόγος
Kosmologie	κοσμολογία
Kosmonaut	κοσμοναύτης
Kosovo	Κοσσυφοπέδιο
Kosten	έξοδα
Kotava	κοτάβα
Kotelett	κοτολέτα
Krabbe	κάβουρας
Krach	θόρυβος
Kraft	δύναμη
Kraftstoff	καύσιμο
Kraftwerk	εργοστάσιο
Kragen	γιακάς
Krakau	Κρακοβία
Krake	χταπόδι
Kralle	νύχι
Krampf	κράμπα
Kran	γερανός
Kranich	γερανός
Krankenhaus	νοσοκομείο
Krankenkassa	ταμείο υγείας
Krankenkasse	ταμείο υγείας
Krankenpflege	νοσηλεία
Krankenpfleger	νοσοκόμος
Krankenschwester	νοσοκόμα
Krankheit	ασθένεια
Kranz	στεφάνι
Krater	κρατήρας
Krater	κρατήρας
Kraut	βότανο
Krawatte	γραβάτα
Kreationismus	δημιουργισμός
Kreativität	δημιουργικότητα
Krebs	κάβουρας
Kredit	δάνειο
Kreditkarte	πιστωτική κάρτα
Krefeld	Κρέφελντ
Kreide	κιμωλία
Kreis	κύκλος
Kreisel	σβούρα
Kreissäge	δισκοπρίονο
Kren	χρένο
Krepppapier	χαρτί κρεπ
Kresse	κάρδαμο
Kreta	Κρήτη
Kreter	Κρητικός
Krethi und Plethi	κάθε καρυδιάς καρύδι
Kretin	κρετίνος
Kreuz	σταυρός
Kreuz des Südens	Νότιος Σταυρός
Kreuzbein	ιερό οστό
Kreuzer	καταδρομικό
Kreuzfahrer	σταυροφόρος
Kreuzfahrt	κρουαζιέρα
Kreuzfahrtschiff	κρουαζιερόπλοιο
Kreuzgang	περιστύλιο
Kreuzkümmel	κύμινο
Kreuzung	σταυροδρόμι
Kreuzworträtsel	σταυρόλεξο
Kreuzzug	σταυροφορία
Krieg	πόλεμος
Kriegsdienstverweigerung	άρνηση
Kriegsende	πόλεμος
Kriegserklärung	κήρυξη
Kriegsschiff	πολεμικό πλοίο
Kriegstreiber	πολεμοκάπηλος
Kriegsverbrechen	έγκλημα πολέμου
Krim	Κριμαία
Kriminalfall	αστυνομική ταινία
Kriminalität	εγκληματικότητα
Kringel	κουλούρι
Krippe	παχνί
Krise	κρίση
Krishna	Κρίσνα
Kristall	κρύσταλλος
Kriterium	κριτήριο
Kritik	κριτική
Kroatien	Κροατία
Kroatisch	Κροατικά
Krokodil	κροκόδειλος
Krokus	κρόκος
Krone	στέμμα
Kronleuchter	πολυέλαιος
Krug	στάμνα
Krume	ψίχα
Krustentier	καρκινοειδής
Kruzifix	σταυρός
Krypta	κρύπτη
Kryptografie	κρυπτογραφία
Krypton	κρυπτό
Krähe	κουρούνα
Kräutertee	βότανα
Krönung	στέψη
Kröte	φρύνος
Krücke	δεκανίκι
Krümel	τρίμμα
Krüppel	σακάτης
Ku-Klux-Klan	Κου-Κλουξ-Κλαν
Kuala Lumpur	Κουάλα Λουμπούρ
Kuba	Κούβα
Kubismus	κυβισμός
Kubus	κύβος m
Kuchen	κέικ
Kuckuck	κούκος
Kugel	σφαίρα
Kugellager	ρουλεμάν
Kugelschreiber	στυλό διαρκείας
Kugelstoßen	σφαιροβολία
Kuh	αγελάδα
Kuhpocken	δαμαλίτιδα
Kuhstall	βουστάσιο
Kult	λατρεία
Kultur	πολιτισμός
Kummer	λύπη
Kumquat	κουμκουάτ
Kunde	πελάτης
Kundendienst	εξυπηρέτηση πελατών
Kundschaft	πελατεία
Kunst	τέχνη
Kupfer	χαλκός
Kupfersulfid	θειούχος
Kuppel	θόλος
Kurdisch	Κουρδικά
Kurdistan	Κουρδιστάν
Kurve	καμπύλη
Kurzfilm	ταινία μικρού μήκους
Kurzform	συντομομορφή
Kurzsichtigkeit	μυωπία
Kurzvokal	βραχύ φωνήεν
Kurzwort	συντομομορφή
Kuss	φιλί
Kutsche	άμαξα
Kutscher	αμαξάς
Kutter	κότερο
Kuwait	Κουβέιτ
Kwass	κβας
Kybernetik	κυβερνητική
Kykladen	Κυκλάδες
Kyoto	Κιότο
Kyrie eleison	Κύριε ελέησον
Kyrilliza	κυριλλικό αλφάβητο
Käfer	σκαθάρι
Käfig	κλουβί
Kälte	κρύο
Känguru	καγκουρό
Kärnten	Καρινθία
Käse	τυρί
Kätzchen	γατάκι
Köcher	φαρέτρα
Köchin	μαγείρισσα
Köder	δόλωμα
Köln	Κολωνία
König	βασιλιάς
Königin	βασίλισσα
Königreich	βασίλειο
Königreich Belgien	Βασίλειο του Βελγίου
Königreich Dänemark	Βασίλειο της Δανίας
Königreich Kambodscha	Βασίλειο της Καμπότζης
Königreich Marokko	Βασίλειο του Μαρόκου
Königreich Norwegen	Βασίλειο της Νορβηγίας
Königreich Saudi-Arabien	Βασίλειο της Σαουδικής Αραβίας
Königreich Schweden	Βασίλειο της Σουηδίας
Königreich Spanien	Βασίλειο της Ισπανίας
Königreich der Niederlande	Βασίλειο των Κάτω Χωρών
Körper	σώμα
Küche	κουζίνα
Küchenschabe	κατσαρίδα
Kühlschrank	ψυγείο
Küken	νεοσσός
Kümmel	αγριοκύμινο
Künstler	καλλιτέχνης
Künstlerin	καλλιτέχνιδα
Kürbis	κολοκύθα
Kürzung	περικοπή
La Gomera	Λα Γκομέρα
La Palma	Λα Πάλμα
Lab	πυτιά
Labor	εργαστήριο
Labradorsee	Θάλασσα του Λαμπραντόρ
Labyrinth	λαβύρινθος
Lachen	γέλιο
Lachs	σολομός
Laden	μαγαζί
Ladentheke	πάγκος
Laderaum	χώρος ψόртωση
Ladung	φορτίο
Lager	αποθήκη
Laie	ερασιτέχνης
Lake	άλμη
Laken	σεντόνι
Lama	λάμα
Lama	λάμα
Lambda	λάμδα
Lamento	γκρίνια
Lamm	αρνί
Lamm Gottes	αμνός
Lampe	λάμπα
Lampenschirm	αμπαζούρ
Land der aufgehenden Sonne	χώρα του ανατέλλοντος ηλίου
Landhaus	αγροτόσπιτο
Landkarte	χάρτης
Landschaft	τοπίο
Landung	προσγείωση
Landwirtschaft	γεωργία
Langeweile	ανία
Langlebigkeit	μακροβιότητα
Langsamkeit	βραδύτητα
Languste	αστακός
Langustine	καραβίδα
Lanthan	λανθάνιο
Laos	Λάος
Laparotomie	λαπαροτομία
Lappen	κουρέλι
Lappland	Λαπωνία
Laptop	φορητός υπολογιστής
Larve	νύμφη
Laryngitis	λαρυγγίτιδα
Las Vegas	Λας Βεγκας
Laser	λέιζερ
Laserstrahl	δέσμη λέιζερ
Last	βάρος
Lastkraftwagen	φορτηγό αυτοκίνητο
Lastwagen	φορτηγό
Latein	Λατινικά
Lateinamerika	Λατινική Αμερική
Lateinisch	λατινικά
Latium	Λάτιο
Latschen	παλιοπάπουτσο
Laubbaum	φυλλοβόλο
Laubwald	φυλλοβόλο δάσος
Lauch	πράσο
Laudatio	εγκώμιο
Laufbahn	καριέρα
Lauge	αλισίβα
Laura	Λαύρα
Laurentius	Λαυρέντιος
Laus	ψείρα
Laut	ήχος
Laute	λαούτο
Lautmalerei	ονοματοποιία
Lautsprecher	μεγάφωνο
Lava	λάβα
Lavalampe	Λάμπα λάβας
Lavendel	λεβάντα
Lawrencium	λωρεντσιο
Layout	σελιδοποίηση
Lazarett	νοσοκομείο
Leander	Λέανδρος
Leben	ζωή
Lebensende	τέλος
Lebensgefährte	σύντροφος
Lebensmittel	τρόφιμα
Lebenspartner	σύντροφος
Leber	ήπαρ
Lebewesen	οργανισμός
Leck	διαρροή
Leda	Λήδα
Leder	δέρμα
Leeuwarden	Λέουβαρντεν
Legasthenie	δυσλεξία
Legende	θρύλος
Legierung	κράμα
Legion	λεγεώνα
Leguan	ιγκουάνα
Legumen	όσπριο
Lehen	φέουδο
Lehm	λάσπη
Lehnwort	δάνειο
Lehnübersetzung	μεταφραστικό δάνειο
Lehrer	δάσκαλος
Lehrerin	δασκάλα
Lehrfach	μάθημα
Lehrstoff	διδακτέος
Leibwächter	σωματοφύλακας
Leiche	πτώμα
Leichenwagen	νεκροφόρα
Leichtathletik	στίβος
Leichtigkeit	ελαφρότητα
Leiden	Λέιντεν
Leinsamen	λιναρόσπορο
Leipzig	Λειψία
Leiste	φάσα
Leistengegend	βουβωνική χώρα
Leistung	κατόρθωμα
Leiter	σκάλα
Leiter	αγωγός
Leitkegel	κώνος σήμανσης
Leitmotiv	λάιτ μοτίβ
Lektion	μάθημα
Lektor	λέκτορας
Lemberg	Λβιβ
Lemma	λήμμα
Leningrad	Λένινγκραντ
Lenkrad	τιμόνι
Lenz	άνοιξη
Leopard	πάνθηρας
Lepra	λέπρα
Lepton	λεπτόνιο
Lerche	κορυδαλλός
Lesbe	λεσβία
Lesbos	Λέσβος
Leser	αναγνώστης
Lesezeichen	σελιδοδείκτης
Lesotho	Λεσόθο
Lethargie	λήθαργος
Lettisch	Λεττονικά
Lettland	Λεττονία
Leuchtkäfer	πυγολαμπίδα
Leuchtturm	φάρος
Leugnung	άρνηση
Leukämie	λευχαιμία
Leute	άνθρωποι
Leutnant	ανθυπολοχαγός
Level	επίπεδο
Leverkusen	Λεβερκούζεν
Levitikus	Λευϊτικό
Lexikograf	λεξικογράφος
Lexikon	εγκυκλοπαίδεια
Libanon	Λίβανος
Libelle	οδοντόγναθο
Liberia	Λιβερία
Librationspunkt	σημείο λίκνισης
Libreville	Λιμπρβίλ
Libussa	Λιμπούσε
Libyen	Λιβύη
Licht	φως
Lichtgeschwindigkeit	ταχύτητα του φωτός
Lichtgriffel	φωτογραφίδα
Lichtjahr	έτος φωτός
Liebe	αγάπη
Liechtenstein	Λίχτενσταϊν
Lied	τραγούδι
Lieferung	παράδοση
Liegestuhl	ξαπλώστρα
Liguster	λιγούστρο
Lilie	κρίνο
Lima	Λίμα
Limassol	Λεμεσός
Limerick	Λίμερικ
Limette	μοσχολέμονο
Limonade	λεμονάδα
Linde	φλαμουριά
Lineal	χάρακας
Linguistik	γλωσσολογία
Linie	γραμμή
Linse	φακή
Linz	Λιντς
Lippe	χείλος
Lippenstift	κραγιόν
Liquid	εξακολουθητικό σύμφωνο
Liquidität	ρευστότητα
Lissabon	Λισαβόνα
List	δόλος
Liste	λίστα
Litanei	δέηση
Litauen	Λιθουανία
Litauisch	λιθουανικά
Liter	λίτρο
Literatur	λογοτεχνία
Lithium	λίθιο
Litotes	λιτότητα
Liturgie	λειτουργία
Livermorium	λιβερμόριο
Liverpool	Λίβερπουλ
Lizenz	άδεια
Lob	έπαινος
Lobotomie	λοβοτομή
Loch	τρύπα
Lockvogel	κράχτης
Logarithmus	λογάριθμος
Logik	λογική
Logo	σήμα κατατεθέν
Lohn	μισθός
Lohnkürzung	περικοπή μισθού
Lokomotive	μηχανή
Lolch	ήρα
London	Λονδίνο
Lorbeer	δάφνη
Lorbeerblatt	δάφνη
Los Angeles	Λος Άντζελες
Lothringen	Λωραίνη
Lotse	πλοηγός
Louisiana	Λουιζιάνα
Luchs	λύγκας
Ludwig	Λουδοβίκος
Ludwigshafen	Λουντβιχσχάφεν
Luftangriff	αεροπορική επιδρομή
Luftaufbereitung	επεξεργασία αέρος
Luftballon	μπαλόνι
Luftbehandlung	επεξεργασία αέρος
Lufterneuerung	ανανέωση του αέρα
Luftfilter	φίλτρο αέρα
Luftreiniger	καθαριστήρας αέρα
Luftröhre	τραχεία
Luftschiff	αερόπλοιο
Luftschlösser bauen	χτίζω πύργους στην άμμο
Luftspiegelung	αντικατοπτρισμούς
Luftwaffe	πολεμική αεροπορία
Luftwechsel	αλλαγή αέρα
Lukas	Λουκάς
Lumpen	κουρέλι
Lunge	πνεύμονας
Lungenentzündung	πνευμονία
Lungenkrebs	καρκίνος
Lupe	μεγεθυντικός φακός
Lust	διάθεση
Lutetium	λουτήτιο
Luxus	πολυτέλεια
Luzern	Λουκέρνη
Luzifer	Εωσφόρος
Lydia	Λυδία
Lydien	Λυδία
Lykien	Λυκία
Lymphe	λέμφος
Lymphknoten	λεμφογάγγλιο
Lyrik	ποίηση
Lächeln	χαμόγελο
Lämpchen	λαμπάκι
Länge	μάκρος
Lärche	λάρικας
Lärm	θόρυβος
Lätzchen	σαλιάρα
Läufer	αξιωματικός
Löffel	κουτάλι
Lösegeld	λύτρα
Lösung	λύση
Löwe	λιοντάρι
Löwenanteil	μερίδα του λέοντος
Löwenzahn	πικραλίδα
Löwin	λιονταρίνα
Lübeck	Λίμπεκ
Lüftung	αερισμός
Lüftungsanlage	μηχανήματα αερισμού
Lüftungseinrichtung	σύστημα αερισμού
Lüftungsgeräusch	θόρυβος αερισμού
Lüftungskanal	αεραγωγός
Lüftungsschlitz	άνοιγμα αερισμού με περσίδες
Lüftungssystem	σύστημα αερισμού
Lüge	ψέμα
Lügen haben kurze Beine	το ψέμα έχει κοντά ποδάρια
Lügner	ψεύτης
Macao	Μακάου
Macher	δραστήριος
Macht	δύναμη
Madagaskar	Μαδαγασκάρη
Madrid	Μαδρίτη
Madrigal	μαδριγάλι
Mafia	μαφία
Magdeburg	Μαγδεβούργο
Magen	στομάχι
Magie	μαγεία
Magma	μάγμα
Magnesit	μαγνησίτης
Magnesium	μαγνήσιο
Magnet	μαγνήτης
Magnetfeld	μαγνητικό πεδίο
Magnetismus	μαγνητισμός
Maharadscha	μαχαραγιάς
Mahl	γεύμα
Mahlzeit	γεύμα
Mahnbrief	επιστολή
Maikäfer	χρυσόμυγα
Mailand	Μιλάνο
Main	Μάιν
Maine	Μέιν
Mainz	Μάιντς
Mais	καλαμπόκι
Majoran	μαντζουράνα
Make-up	μακιγιάζ
Makedonien	Μακεδονία
Makrele	σκουμπρί
Malachias	Μαλαχίας
Malachit	μαλαχίτης
Malaria	ελονοσία
Malawi	Μαλάουι
Malaysia	Μαλαισία
Malediven	Μαλδίβες
Maler	ζωγράφος
Malerei	ζωγραφική
Mali	Μάλι
Mallorca	Μαγιόρκα
Malmö	Μάλμε
Malta	Μάλτα
Maltesisch	μαλτέζικα
Malz	βύνη
Mammut	μαμούθ
Management	διαχείρηση
Manager	μάνατζερ
Manaus	Μανάους
Manchester	Μάντσεστερ
Mandarine	μανταρίνι
Mandel	αμύγδαλο
Mandoline	μαντολίνο
Manga	μάνγκα
Mangan	μαγγάνιο
Mango	μάνγκο
Mangold	σέσκουλο
Manhattan	Μανχάταν
Manichäismus	μανιχαϊσμός
Manie	μανία
Manifest	μανιφέστο
Manila	Μανίλα
Mann	άντρας
Mannheim	Μάνχαϊμ
Mannschaft	πλήρωμα
Mantel	παλτό
Mantra	μάντρα
Marathon	μαραθώνιος
Marburg	Μάρμπουργκ
Marder	δενδροκούναβο
Margarete	Μαργαρίτα
Margarine	μαργαρίνη
Marginalisierung	περιθωριοποίηση
Maria	Μαρία
Marienkäfer	πασχαλίτσα
Marihuana	μαριχουάνα
Marionette	μαριονέτα
Mark	μεδούλι
Marketing	μάρκετινγκ
Markise	τέντα
Markt	αγορά
Marktplatz	αγορά
Markus	Μάρκος
Marmelade	μαρμελάδα
Marmor	μάρμαρο
Marokko	Μαρόκο
Mars	Μαρς
Marsch	εμβατήριο
Marseillaise	Μασσαλιώτιδα
Marseille	Μασσαλία
Marshallinseln	Νήσοι Μάρσαλ
Martin	Μαρτίνος
Martinique	Μαρτινίκα
Marxismus	μαρξισμός
Maryland	Μέριλαντ
Marzipan	αμυγδαλόπαστα
Maräne	κορέγονος
Maschine	μηχανή
Maschinengewehr	πολυβόλο
Masern	ιλαρά
Maseru	Μαζέρου
Maske	μάσκα
Massachusetts	Μασαχουσέτη
Massage	μάλλαξη
Massaker	σφαγή
Masse	μάζα
Massenandrang	στριμωξίδι
Mast	κατάρτι
Mastadenitis	μαστίτιδα
Mastitis	μαστίτιδα
Masturbation	αυνανισμός
Material	υλικό
Mathematik	μαθηματικά
Mathematiker	μαθηματικός
Matratze	στρώμα
Matriarchat	μητριαρχία
Matrix	μήτρα
Matrose	ναύτης
Matthäus	Ματθαίος
Mauer	τοίχος
Mauersegler	μαυροσταχτάρα
Maul	στόμα
Maulbeerbaum	μουριά
Maulesel	γίννος
Maulkorb	μουσάδα
Maulwurf	ασπάλακας
Maurer	χτίστης
Mauretanien	Μαυριτανία
Mauritius	Μαυρίκιος
Maus	ποντίκι
Mausoleum	μαυσωλείο
Maya	Μάγια
Mayonnaise	μαγιονέζα
Mayotte	Μαγιότ
Mazedonien	Μακεδονία
Maß	μέτρο
Maßnahme	μέτρο
Mechanik	μηχανική
Mechanismus	μηχανισμός
Mecklenburg-Vorpommern	Μεκλεμβούργο-Δυτική Πομερανία
Medaille	παράσημο
Medea	Μήδεια
Meditation	διαλογισμός
Medizin	ιατρική
Mediziner	ιατρός
Meer	θάλασσα
Meerbarbe	μπαρμπούνι
Meeresboden	βυθός
Meeresfrüchte	θαλασσινά
Meeresgrund	θαλάσσιος βυθός
Meeresströmung	θαλάσσιο ρεύμα
Meerjungfrau	γοργόνα
Meerrettich	παρανάκι
Meerschweinchen	ινδικό χοιρίδιο
Meerwasser	θαλάσσια ύδατα
Meeräsche	κέφαλος
Mehl	αλεύρι
Mehrheit	πλειοψηφία
Mehrzahl	πληθυντικός
Meile	μίλι
Meineid	ψευδορκία
Meinungsforscher	δημοσκόπος
Meinungsumfrage	δημοσκόπηση
Meinungsverschiedenheit	ασυμφωνία
Meiose	μείωσις
Meister	μάστορας
Meisterschaft	πρωτάθλημα
Meißel	καλέμι
Mekka	Μέκκα
Melancholie	μελαγχολία
Melanesien	Μελανησία
Melbourne	Μελβούρνη
Melilla	Μελίγια
Melodie	μελωδία
Melone	πεπόνι
Melpomene	Μελπομένη
Mem	μιμίδιο
Memorandum	μνημόνιο
Mendelevium	μεντελέβιο
Menge	ποσότητα
Meningitis	μηνιγγίτιδα
Menopause	εμμηνόπαυση
Mensch	άνθρωπέ μου
Mensch	άνθρωπος
Menschenmenge	πλήθος
Menschenrecht	ανθρώπινο δικαίωμα
Menschheit	ανθρωπότητα
Menstruation	εμμηνόρροια
Menü	μενού
Meridian	μεσημβρινός
Merkur	Ερμής
Merowinger	Μεροβίνγκοι
Meson	μεσόνιο
Mesopotamien	Μεσοποταμία
Mesosphäre	μεσόσφαιρα
Messe	λειτουργία
Messer	μαχαίρι
Messias	Μεσσίας
Messing	ορείχαλκος
Messung	μέτρηση
Mesusa	μεζουζά
Metall	μέταλλο
Metamorphose	μεταμόρφωση
Metapher	μεταφορά
Meteor	μετέωρο
Meteorit	μετεωρίτης
Meteorologie	μετεωρολογία
Meter	μέτρο
Methode	μέθοδος
Metonymie	μετωνυμία
Metronom	μετρονόμος
Metropole	μητρόπολη
Metropolis	μητρόπολη
Mette	όρθρος
Mexikaner	Μεξικανός
Mexiko	Μεξικό
Miami	Μαϊάμι
Micha	Μιχαίας
Michael	Μιχαήλ
Michigan	Μίσιγκαν
Micky Maus	Μίκυ Μάους
Miene	όψη
Miesmuschel	μύδι
Miete	ενοίκιο
Mieterhöhung	ενοίκιο
Mietwagen	ενοικιαζόμενο αυτοκίνητο
Migrant	μετανάστης
Migräne	ημικρανία
Mikrobe	μικρόβιο
Mikrobiologie	μικροβιολογία
Mikrofon	μικρόφωνο
Mikronesien	Μικρονησία
Mikroorganismus	μικροοργανισμός
Mikroprozessor	μικροεπεξεργαστής
Mikroskop	μικροσκόπιο
Mikrowellenherd	φούρνος μικροκυμάτων
Milan	τσίφτης
Milch	γάλα
Milchstraße	Γαλαξίας
Milchsäure	γαλακτικό οξύ
Militarismus	μιλιταρισμός
Militär	στρατιωτικός
Militär	στρατός
Militärdienst	θητεία
Millimeter	χιλιοστόμετρο
Million	εκατομμύριο
Milz	σπλήνας
Milzbrand	άνθρακας
Mimik	μιμική
Minarett	μιναρές
Mindanao	Μιντανάο
Minderheit	μειονότητα
Minderjähriger	ανήλικος
Minderjährigkeit	ανηλικότητα
Minderwertigkeitskomplex	σύμπλεγμα κατωτερότητας
Mindestlohn	κατώτερος μισθός
Mine	ορυχείο
Minenfeld	ναρκοπέδιο
Mineral	ορυκτό
Mineralstoff	ορυκτό άλας
Mineralwasser	νερό
Minimum	ελάχιστο
Minister	υπουργός
Ministerium	υπουργείο
Ministerpräsident	πρωθυπουργός
Minsk	Μινσκ
Minute	λεπτό
Minze	μέντα
Miraculix	Πανοραμίξ
Misanthrop	μισάνθρωπος
Mischluft	αναμεμιγμένος αέρας
Mischung	μείγμα
Misere	μιζέρια
Misogyn	μισογύνης
Misogynie	μισογυνία
Mispel	μουσμουλιά
Missbilligung	αποδοκιμασία
Missbrauch	κατάχρηση
Misserfolg	αποτυχία
Missgunst	δυσμένεια
Mississippi	Μισισίπι
Mississippi	Μισισίπι
Missverständnis	παρεξήγηση
Mistel	ιξός
Misteldrossel	τσαρτσάρα
Mitarbeiter	συνεργάτης
Mitbestimmung	συμμετοχή
Mitgift	προίκα
Mitglied	μέλος
Mitlaut	σύμφωνο
Mitleid	συμπόνια
Mitmensch	συνάνθρωπος
Mitochondrium	μιτοχόνδριο
Mitose	μίτωσισ
Mittag	μεσημέρι
Mittagessen	γεύμα
Mittagsdämon	ακηδία
Mitte	μέση
Mittelalter	Μεσαίωνας
Mitteleuropa	Κεντρική Ευρώπη
Mitteleuropäer	κεντροευρωπαίος
Mittelfinger	μεσαίο δάχτυλο
Mittelmeer	Μεσόγειος Θάλασσα
Mittelpunkt	κέντρο
Mittelschicht	τάξη
Mittelwort	μετοχή
Mitternacht	μεσάνυχτα
Mittwoch	Τετάρτη
Mixer	μίξερ
Mobilisierung	κινητοποίηση
Mobiltelefon	κινητό τηλέφωνο
Mode	μόδα
Modell	μοντέλο
Modem	διαποδιαμορφωτής
Moderatorin	παρουσιάστρια
Mogadischu	Μογκαντίσου
Mohammed	Μωάμεθ
Mohammedaner	μωαμεθανός
Mohn	παπαρούνα
Mol	γραμμομόριο
Molch	τρίτων
Moldau	Μολδάβας
Moldau	Μολδαβία
Moldawien	Μολδαβία
Mole	μόλος
Molekularbiologie	μοριακή βιολογία
Molekül	μόριο
Molke	τυρόγαλα
Molkerei	γαλακτοκομείο
Moll	ελάσσων
Molybdän	μολυβδαίνιο
Monaco	Μονακό
Monade	μονάδα
Monarch	μονάρχης
Monarchie	μοναρχία
Monat	μήνας
Monatsgehalt	μηνιάτικο
Monatslohn	μηνιάτικο
Monatsverdienst	μηνιάτικο
Mond	δορυφόρος
Mondfinsternis	έκλειψη Σελήνης
Mondlandung	προσελήνωση
Mondschein	σεληνόφως
Mongole	Μόγγολος
Mongolei	Μογγολία
Mongolisch	μογγολικά
Monogamie	μονογαμία
Monogramm	μονόγραμμα
Monolog	μονόλογος
Monom	μονώνυμο
Monotheismus	μονοθεϊσμός
Montag	Δευτέρα
Montana	Μοντάνα
Montblanc	Λευκό Όρος
Montenegro	Μαυροβούνιο
Montevideo	Μοντεβιδέο
Montreal	Μόντρεαλ
Montréal	Μόντρεαλ
Moos	βρύο
Moral	ηθική
Moratorium	μορατόριο
Mord	ανθρωποκτονία
Morgen	πρωί
Morgendämmerung	αυγή
Morgengrauen	χάραμα
Morgenmantel	ρόμπα
Mormone	μορμόνος
Morphem	μόρφημα
Morphologie	μορφολογία
Mosaik	ψηφιδωτό
Mosambik	Μοζαμβίκη
Moschee	τζαμί
Mosel	Μοζέλλας
Moskau	Μόσχα
Moskowiter	Μοσχοβίτης
Moskowiterin	Μοσχοβίτισσα
Moslem	μουσουλμάνος
Motor	κινητήρας
Motorrad	μοτοσυκλέτα
Motte	σκόρος
Mount Everest	Έβερεστ
Mouse	ποντίκι
Moussaka	μουσακάς
Muezzin	μουεζίνης
Mufflon	μουφλόν
Multikulturalismus	πολυπολιτισμικότητα
Multiplikation	πολλαπλασιασμός
Multitalent	πολυτάλαντος
Multiversum	πολυσύμπαν
Mumbai	Μούμπαη
Mumie	μούμια
Mumps	παρωτίτιδα
Mund	στόμα
Mundharmonika	φυσαρμόνικα
Mundstück	επιστόμιο
Murmeltier	μαρμότα
Murphys Gesetz	Νόμος του Μέρφι
Musala	Μουσαλά
Muschel	μύδι
Muschi	αιδοίο
Muse	μούσα
Muselman	μουσουλμάνος
Museum	μουσείο
Musical	μιούζικαλ
Musik	μουσική
Musiker	μουσικός
Musikgruppe	συγκρότημα
Musikinstrument	όργανο
Musikwissenschaft	μουσικολογία
Muskel	μυς
Muskete	μουσκέτο
Musselin	μουσελίνα
Mut	θάρρος
Mutation	μετάλλαξη
Mutter	μητέρα
Muttergottes	Θεοτόκος
Mutterkuchen	πλακούντας
Mutterschaft	μητρότητα
Muttersprache	μητρικός
My	μι
Myanmar	Μυανμάρ
Mykene	Μυκήνες
Myriade	μύριο
Myroblyt	μυροβλύτης
Myrrhe	μύρο
Myrte	μυρτιά
Mysterium	μυστήριο
Mythologie	μυθολογία
Mythos	μύθος
Málaga	Μάλαγα
Mäander	μαίανδρος
Mädchen	κορίτσι
Mädchenname	γένος
Mähdrescher	θεριζοαλωνιστική μηχανή
Mähne	χαίτη
Mähren	Μοραβία
Märchen	παραμύθι
Märtyrer	μάρτυρας
Möbel	έπιπλο
Möbelstück	έπιπλο
Möglichkeit	δυνατότητα
Möhre	καρότο
Mönch	μοναχός
Mönchengladbach	Μενχενγκλάντμπαχ
Mörder	δολοφόνος
Mörderin	φόνισσα
Mörser	γουδί
Möwe	γλάρος
Mücke	κουνούπι
Müdigkeit	κούραση
Mühe	κόπος
Mühle	μύλος
Mühlstein	μυλόπετρα
Mülhausen	Μυλούζ
Müll	σκουπίδια
Mülleimer	σκουπιδοτενεκές
Müller	μυλωνάς
München	Μόναχο
Mündung	εκβολή
Münster	Μύνστερ
Münze	νόμισμα
Mütze	σκουφί
NGO	ΜΚΟ
Nabel	ομφαλός
Nabelschau	ομφαλοσκοπία
Nabelschnur	ομφάλιος λώρος
Nachahmung	μίμηση
Nachbar	γείτονας
Nachbarland	γείτων
Nachbeben	δόνηση
Nachfolger	διάδοχος
Nachhut	οπισθοφυλακή
Nachkomme	απόγονος
Nachmittag	απόγευμα
Nachname	επώνυμο
Nachricht	νέο
Nachschlagewerk	εγκυκλοπαίδεια
Nachsicht	επιείκεια
Nacht	νύχτα
Nachteil	μειονέκτημα
Nachtigall	αηδόνι
Nachtisch	επιδόρπιο
Nachtkerze	νυχτολούλουδο
Nachtklub	νάιτ κλαμπ
Nachtleben	νυχτερινή ζωή
Nachttisch	κομοδίνο
Nachtzug	νυχτερινό τρένο
Nachweis	απόδειξη
Nachzug	μετοίκηση
Nacken	αυχένας
Nacktheit	γυμνότητα
Nadel	βελόνα
Nadelbaum	κωνοφόρο
Nadir	ναδίρ
Nagasaki	Ναγκασάκι
Nagel	νύχι
Naher Osten	Εγγύς Ανατολή
Nahost	Εγγύς Ανατολή
Nahrung	τροφή
Nahrungskette	αλυσίδα
Nahrungsmangel	έλλειψη
Nahrungsmittel	τρόφιμα
Nahrungsmittelknappheit	τρόφιμα
Naht	γαζί
Nahum	Ναούμ
Nairobi	Ναϊρόμπι
Najade	ναϊάδα
Name	όνομα
Namenstag	γιορτή
Namibia	Ναμίμπια
Nantes	Νάντη
Narbe	ουλή
Nargileh	ναργιλές
Narr	γελωτοποιός
Narwal	φάλαινα νάρβαλ
Narziss	Νάρκισσος
Narzisse	νάρκισσος
Narzissmus	ναρκισσισμός
Nase	μύτη
Nasenloch	ρουθούνι
Nashorn	ρινόκερος
Nashville	Νάσβιλ
Natalie	Ναταλία
Nation	έθνος
Nationalhymne	εθνικός ύμνος
Nationalismus	εθνικισμός
Nationalpark	εθνικό πάρκο
Nationalsozialismus	εθνικοσοσιαλισμός
Nationalstaat	εθνικό κράτος
Natrium	νάτριο
Natur	φύση
Naturkatastrophe	φυσική καταστροφή
Naturwissenschaft	φυσική επιστήμη
Nauru	Ναουρού
Nautik	ναυτική
Navarra	Ναβάρρα
Nazismus	ναζισμός
Neapel	Νάπολη
Nebel	ομίχλη
Nebenwirkung	παρενέργεια
Nebraska	Νεμπράσκα
Neckar	Νέκαρ
Neffe	ανιψιός
Nehemia	Νεεμίας
Neid	φθόνος
Nektarine	νεκταρίνι
Nelke	γαρίφαλο
Nenner	παρονομαστής
Neodym	νεοδύμιο
Neologismus	νεολογισμός
Neon	νέον
Nepal	Νεπάλ
Nepotismus	νεποτισμός
Neptun	Ποσειδώνας
Neptunium	ποσειδώνιο
Nerv	νεύρο
Nerz	βιζόν
Nest	φωλιά
Netz	δίχτυ
Netzhaut	αμφιβληστροειδής χιτώνας
Neu-Delhi	Νέο Δελχί
Neues Testament	Καινή Διαθήκη
Neugriechisch	νεοελληνικά
Neuigkeit	νέο
Neujahr	Πρωτοχρονιά
Neukaledonien	Νέα Καληδονία
Neumond	νέα σελήνη
Neuplatonismus	νεοπλατωνισμός
Neuralgie	νευραλγία
Neurose	νεύρωση
Neuseeland	Νέα Ζηλανδία
Neuspanien	Νέα Ισπανία
Neutralität	ουδετερότητα
Neutrino	νετρίνο
Neutron	νετρόνιο
Neutrum	ουδέτερο
Nevada	Νεβάδα
New Hampshire	Νιου Χάμσαϊρ
New Jersey	Νιού Τζέρσεϊ
New Orleans	Νέα Ορλεάνη
New York	Νέα Υόρκη
Nicaragua	Νικαράγουα
Nicaraguaner	Νικαραγουανός
Nicaraguanerin	Νικαραγουανή
Nichte	ανεψιά
Nichtregierungsorganisation	μη κυβερνητικός οργανισμός
Nichts	κενό
Nichtschwimmerin	κολυμβήτρια
Nickel	νικέλιο
Nickerchen	υπνάκος
Nicole	Νικολέτα
Nicäa	Νίκαια
Niederbayern	Κάτω Βαυαρία
Niedergang	παρακμή
Niederlage	ήττα
Niederlande	Κάτω Χώρες
Niederländer	Ολλανδός
Niederländisch	ολλανδικά
Niederländische Antillen	Ολλανδικές Αντίλλες
Niedersachsen	Κάτω Σαξωνία
Niederschlag	υετός
Niederösterreich	Κάτω Αυστρία
Niere	νεφρό
Niesen	φτάρνισμα
Niger	Νίγηρας
Niger	Νίγηρας
Nigeria	Νιγηρία
Nihonium	νιχόνιο
Nike	Νίκη
Nikobaren	Νικομπάρ
Nikolaus	Νικόλαος
Nikosia	Λευκοσία
Nikotin	νικοτίνη
Nil	Νείλος
Niob	νιόβιο
Niobe	Νιόβη
Niue	Νιούε
Niveau	επίπεδο
Nizza	Νίκαια
Noah	Νώε
Nobelium	νομπέλιο
Nobelpreis	βραβείο Νόμπελ
Nomen	όνομα
Nominativ	ονομαστική
Nonchalance	νωχέλεια
Nonne	μοναχή
Nord	βορράς
Nordamerika	Βόρεια Αμερική
Norden	βορράς
Nordeuropa	Βορειά Ευρώπη
Nordirland	Βόρεια Ιρλανδία
Nordkorea	Βόρεια Κορέα
Nordküste	βόρεια ακτή
Nordmazedonien	Βόρεια Μακεδονία
Nordrhein-Westfalen	Βόρεια Ρηνανία-Βεστφαλία
Nordsee	Βόρεια Θάλασσα
Nordzypern	Βόρεια Κύπρος
Normalität	κανονικότητα
Normandie	Νορμανδία
North Dakota	Βόρεια Ντακότα
Norwegen	Νορβηγία
Norwegisch	νορβηγικά
Nostalgie	νοσταλγία
Notar	συμβολαιογράφος
Notariat	συμβολαιογραφείο
Notarin	συμβολαιογράφος
Notausgang	έξοδος κινδύνου
Note	νότα
Notlandung	προσγείωση
Notwasserung	προσθαλάσσωση
Nova Scotia	Νέα Σκωτία
Novelle	νουβέλα
Nowosibirsk	Νοβοσιμπίρσκ
Nuckel	πιπίλα
Nudel	ζυμαρικό
Nudelholz	πλάστης
Nukleinsäure	νουκλεϊκό οξύ
Null	μηδέν
Numeri	Αριθμοί
Numidien	Νουμιδία
Nummer	αριθμός
Nunavut	Νούναβουτ
Nuntius	νούντσιος
Nuss	καρύδι
Nussknacker	καρυοθραύστης
Nutation	κλόνηση
Nutzpflanze	καλλιεργούμενος
Nutzung	χρήση
Nuuk	Νουούκ
Ny	νι
Nylon	νάιλον
Nähmaschine	ραπτομηχανή
Nähzeug	ραπτικά
Nörgelei	γκρίνια
Nörgeln	γκρίνια
Nörgler	γκρινιάρης
Nörglerin	γκρινιάρα
Nürnberg	Νυρεμβέργη
Oase	όαση
Obadja	Οβδιού
Obduktion	νεκροψία
Obelisk	οβελίσκος
Obelix	Οβελίξ
Oberbefehlshaber	αρχιστράτηγος
Oberbegriff	υπερώνυμο
Oberfläche	επιφάνεια
Oberlippe	άνω χείλος
Oberst	συνταγματάρχης
Obervolta	Άνω Βόλτα
Objekt	αντικείμενο
Oboe	όμποε
Obst	φρούτα
Obstbaum	οπωροφόρο
Obstladen	οπωροπωλείο
Ochse	βόδι
Ocker	ώχρα
Odaliske	οδαλίσκη
Odense	Όντενσε
Odessa	Οδησσός
Odyssee	Οδύσσεια
Odysseus	Οδυσσέας
Oesophagus	οισοφάγος
Ofen	φούρνος
Offenbarung	Αποκάλυψη
Offizier	αξιωματικός
Ohio	Οχάιο
Ohio	Οχάιο
Ohm	ωμ
Ohr	αφτί
Ohrfeige	χαστούκι
Ohrläppchen	λοβός
Ohrmuschel	πτερύγιο ωτός
Okapi	οκάπι
Okarina	οκαρίνα
Okeanos	Ωκεανός
Okkultismus	αποκρυφισμός
Oklahoma	Οκλαχόμα
Oktave	οκτάβα
Oktopus	χταπόδι
Okzitanisch	οξιτανικά
Oligarchie	ολιγαρχία
Olive	ελιά
Olivenöl	ελαιόλαδο
Olymp	Όλυμπος
Olympiasieger	ολυμπιονίκης
Olympische Sommerspiele	Θερινοί Ολυμπιακοί Αγώνες
Olympische Spiele	Ολυμπιακοί Αγώνες
Olympische Winterspiele	Χειμερινοί Ολυμπιακοί Αγώνες
Oma	γιαγιά
Oman	Ομάν
Omega	ωμέγα
Omelett	ομελέτα
Omikron	όμικρον
Omnivore	παμφάγος
Omsk	Ομσκ
Onkel	θείος
Onkologie	ογκολογία
Ontario	Οντάριο
Ontologie	οντολογία
Oper	όπερα
Operation	εγχείρηση
Operette	οπερέτα
Opfer	θυσία
Opium	όπιο
Optik	οπτική
Optimierung	βελτιστοποίηση
Orang-Utan	ουρακοτάγκος
Orange	πορτοκάλι
Orange	πορτοκαλί
Orangenbaum	πορτοκαλιά
Orangenlimonade	πορτοκαλάδα
Orchester	ορχήστρα
Orchidee	ορχιδέα
Ordinate	τεταγμένη
Ordnung	τάξη
Ordovizium	Ορδοβίκια
Oregano	ρίγανη
Oregon	Όρεγκον
Organ	όργανο
Organisation	οργανισμός
Organismus	οργανισμός
Orgasmus	οργασμός
Orgel	όργανο
Orgie	παρτούζα
Origami	οριγκάμι
Orion	Ωρίων
Orion	Ωρίων
Ork	ορκ
Orkan	τυφώνας
Ort	τόπος
Ortsname	τοπωνύμιο
Oslo	Όσλο
Osmanisches Reich	Οθωμανική Αυτοκρατορία
Osmium	όσμιο
Osmose	ώσμωση
Ost-Berlin	Ανατολικό Βερολίνο
Osten	ανατολή
Osterei	πασχαλινό
Osterhase	λαγουδάκι του Πάσχα
Osterinsel	Νησί του Πάσχα
Ostermontag	Δευτέρα του Πάσχα
Ostern	Πάσχα
Ostersonntag	Κυριακή του Πάσχα
Osteuropa	Ανατολική Ευρώπη
Ostküste	ανατολική ακτή
Ostpreußen	Ανατολική Πρωσία
Ostrazismus	εξοστρακισμός
Ostsee	Βαλτική
Osttimor	Ανατολικό Τιμόρ
Otaku	οτάκου
Ottawa	Οττάβα
Otter	ενυδρίδα
Otto Normalverbraucher	ο πρώτος τυχόν, ο πάσα ένας
Ouagadougou	Ουαγκαντουγκού
Ouzo	ούζο
Oxford	Οξφόρδη
Oxytonon	οξύτονος
Ozean	ωκεανός
Ozeanien	Ωκεανία
Ozelot	αιλουρότιγρη
Ozon	όζον
Ozonator	οζονιστήρας
Ozongenerator	οζονιστήρας
Paar	ζευγάρι
Page	γκρουμ
Pagode	παγόδα
Paket	πακέτο
Pakistan	Πακιστάν
Palast	παλάτι
Palau	Παλάου
Palaver	φλυαρίες
Palawan	Παλαβάν
Palermo	Παλέρμο
Palette	παλέτα
Palimpsest	παλίμψηστος
Palindrom	καρκινική επιγραφή
Palladium	παλλάδιο
Palme	φοίνικας
Palmenstrand	φοινικόδασος
Palmsonntag	Κυριακή των Βαΐων
Palmyra	Παλμύρα
Palmöl	φοινικέλαιο
Paläontologie	παλαιοντολογία
Paläozoikum	Παλαιοζωική εποχή
Palästina	Παλαιστίνη
Palästinenser	Παλαιστίνιος
Panama	Παναμάς
Panda	πάντα
Pandeismus	παντεϊσμός
Pandemie	πανδημία
Panentheismus	πανενθεϊσμός
Panettone	πανετόνε
Panflöte	σύριγγα
Pangäa	Παγγαία
Panik	πανικός
Pankreas	πάγκρεας
Pankreatitis	παγκρεατίτις
Pannonien	Πανόνια
Panorama	πανόραμα
Pantheismus	πανθεϊσμός
Pantheon	πάνθεον
Panther	πάνθηρας
Pantherpilz	Αμανίτης ο πάνθηρας
Pantoffel	παντόφλα
Panzytopenie	παγκυτταροπενία
Papagei	παπαγάλος
Papaya	παπάγια
Papier	χαρτί
Papiertiger	χάρτινη τίγρη
Pappel	λεύκα
Paprika	πιπεριά
Papst	πάπας
Papua-Neuguinea	Παπούα Νέα Γουινέα
Papyrus	πάπυρος
Para	χρήματα
Parabel	παραβολή
Paradies	παράδεισος
Paradigma	παράδειγμα
Paraguay	Παραγουάη
Parallaxe	παράλλαξη
Parallelogramm	παραλληλόγραμμο
Paralleluniversum	παράλληλο σύμπαν
Paramaribo	Παραμαρίμπο
Parameter	παράμετρος
Paranoia	παράνοια
Parasit	παράσιτο
Pareidolie	παρειδωλία
Parenthese	παύλα
Parfüm	άρωμα
Parfümerie	αρωματοπωλείο
Paris	Παρίσι
Park	πάρκο
Parka	παρκά
Parkett	παρκέ
Parkplatz	πάρκινγκ
Parlament	κοινοβούλιο
Parlamentarier	βουλευτής
Parodie	παρωδία
Parodontitis	περιοδοντίτιδα
Parodontose	ουλίτιδα
Paroxytonon	παροξύτονος
Partei	κόμμα
Parthenophobie	παρθενοφοβία
Partikel	μόριο
Partikel	μόριο
Partitur	παρτιτούρα
Partizip	μετοχή
Partizipation	συμμετοχή
Partner	παρτενέρ
Party	πάρτι
Pascal	Πασκάλ
Pascha	πασάς
Pass	διαβατήριο
Passagier	επιβάτης
Passant	περαστικός
Passau	Πάσσαου
Passiv	παθητική φωνή
Pastor	πάστορας
Patagonien	Παταγονία
Pate	νονός
Pate stehen	ουσιαστικά
Patenkind	βαφτισιμιός
Patent	ευρεσιτεχνία
Patient	ασθενής
Patin	νονά
Patriarch	πατριάρχης
Patriotismus	πατριωτισμός
Pauke	τύμπανο
Paul	Παύλος
Pause	διάλειμμα
Pausenaufsicht	εφημερία
Pavian	μπαμπουίνος
Pazifischer Ozean	Ειρηνικός
Pazifismus	πασιφισμός
Pech	πίσσα
Pegasus	Πήγασος
Pegel	στάθμη
Peitsche	μαστίγιο
Peking	Πεκίνο
Pelikan	πελεκάνος
Peloponnes	Πελοπόννησος
Pendant	αντίστοιχο
Pendel	εκκρεμές
Penetration	διείσδυση
Penis	πέος
Pensa	Πένζα
Pension	οικοτροφείο
Pensionistenheim	οίκος ευγηρίας
Pentagramm	πεντάγραμμο
Pentan	πεντάνιο
Pepsin	πεψίνη
Perfektion	τελειότητα
Perfektionismus	τελειομανία
Pergament	περγαμηνή
Pergola	πέργκολα
Perihel	περιήλιο
Periode	περίοδος
Periodensystem	περιοδικός πίνακας των χημικών στοιχείων
Periskop	περισκόπιο
Peristaltik	περίσταλση
Peritoneum	περιτόναιο
Perle	μαργαριτάρι
Perlmutt	μάργαρο
Perlmutter	μάργαρο
Permanenz	μονιμότητα
Perseus	Περσέας
Perseus	Περσέας
Persiflage	παρωδία
Persisch	περσικά
Persischer Golf	Περσικός Κόλπος
Person	άτομο
Personalabteilung	τμήμα
Personalausweis	δελτίο ταυτότητας
Personenkult	προσωπολατρία
Perspektive	άποψη
Peru	Περού
Perücke	περούκα
Pessimismus	απαισιοδοξία
Pest	πανούκλα
Pesto	πέστο
Peter	Πέτρος
Peterling	μαϊντανός
Petersdom	Βασιλική του Αγίου Πέτρου
Petersilie	μαϊντανός
Petunie	πετούνια
Pfad	μονοπάτι
Pfahl	πάσσαλος
Pfand	ενέχυρο
Pfanne	τηγάνι
Pfannkuchen	τηγανίτα
Pfarrer	παπάς
Pfau	παγώνι
Pfeffer	πιπέρι
Pfeife	πίπα
Pfeil	βέλος
Pferd	άλογο
Pferdeschwanz	αλογοουρά
Pferdestärke	ιπποδύναμη
Pfingsten	Πεντηκοστή
Pfirsich	ροδάκινο
Pflanze	φυτό
Pflege	νοσηλεία
Pflicht	υποχρέωση
Pflug	άροτρο
Pforzheim	Πφόρτσχαϊμ
Pfund	λίρα
Pfütze	λακκούβα
Phalanx	φάλαγγα
Phallus	φαλλός
Pharao	φαραώ
Pharmakologie	φαρμακολογία
Pharmazie	φαρμακευτική
Phase	φάση
Phelonium	φαιλόνι
Phenolphthalein	φαινολοφθαλεΐνη
Philanthrop	φιλάνθρωπος
Philemon	Φιλήμων
Philipp	Φίλιππος
Philipper	Φιλιππησίους
Philippinen	Φιλιππίνες
Philologie	φιλολογία
Philosoph	φιλόσοφος
Philosophie	φιλοσοφία
Phnom Penh	Πνομ Πεν
Phobie	φοβία
Phoenix	Φοίνιξ
Phonem	φώνημα
Phonologie	φωνολογία
Phosphor	φωσφόρος
Photon	φωτόνιο
Physik	φυσική
Physiker	φυσικός
Physiognomik	φυσιογνωμονική
Physiologie	φυσιολογία
Phytolith	φυτόλιθος
Phytopathologie	φυτοπαθολογία
Phänomen	φαινόμενο
Phänomenologie	φαινομενολογία
Phönix	φοίνικας
Phönizier	Φοίνικες
Piemont	Πεδεμόντιο
Pik	μπαστούνι
Pilot	πιλότος
Pilotprojekt	πιλοτικό πρόγραμμα
Pilz	μανιτάρι
Pimmel	πουλί
Pinguin	πιγκουίνος
Pinienkern	κουκουνάρι
Pinzette	τσιμπίδα
Pirat	πειρατής
Pistole	πιστόλι
Pita	πίτα
Piva	Πίβα
Pizza	πίτσα
Pizzeria	πιτσαρία
Pjöngjang	Πιονγιάνγκ
Plagiat	λογοκλοπή
Plakat	αφίσα
Planet	πλανήτης
Planetarium	πλανητάριο
Plankton	πλανκτόν
Plantage	φυτεία
Plasma	πλάσμα
Plastik	πλαστικό
Plastik	γλυπτική
Plastiktüte	πλαστική σακούλα
Platin	λευκοχρυσος
Plattensammlung	δισκοθήκη
Plattensee	λίμνη Μπάλατον
Platz	πλατεία
Plazenta	πλακούντας
Pleonasmus	πλεονασμός
Plural	πληθυντικός
Pluto	Πλούτωνας
Plutokratie	πλουτοκρατία
Plutonium	πλουτώνιο
Plätzchen	μπισκότο
Plünderung	λεηλασία
Pocke	ευλογιά
Podgorica	Ποντγκόριτσα
Poesie	ποίηση
Poet	ποιητής
Pogrom	πογκρόμ
Poker	πόκερ
Pol	πόλος
Polarkreis	πολικός κύκλος
Polarlicht	σέλας
Pole	Πολωνός
Polemik	πολεμική
Polen	Πολωνία
Polin	Πολωνή
Politesse	γυναίκα τροχονόμος
Politik	πολιτική
Politiker	πολιτικός
Politologe	πολιτολόγος
Polizei	αστυνομία
Polizist	αστυνόμος
Polizistin	αστυνόμος
Polka	πόλκα
Polnisch	πολωνικά
Polonium	πολώνιο
Polygamie	πολυγαμία
Polymer	πολυμερές
Polynesien	Πολυνησία
Polynom	πολυώνυμο
Polytheismus	πολυθεϊσμός
Pomeranze	νεραντζιά
Pommern	Πομερανία
Pommes frites	πατάτες τηγανιτές
Pompeji	Πομπηία
Pool	πισίνα
Popcorn	ποπκόρν
Population	πληθυσμός
Pornografie	πορνογραφία
Porree	πράσο
Port	θύρα
Portemonnaie	χαρτοφύλακας
Portier	θυρωρός
Porträt	πορτρέτο
Portugal	Πορτογαλία
Portugiesisch	Πορτογαλικά
Portwein	οίνος Πορτογαλίας
Porzellan	πορσελάνη
Posaune	τρομπόνι
Poseidon	Ποσειδώνας
Posen	Πόζναν
Positiv	θετικός
Positron	ποζιτρόνιο
Possessivpronomen	κτητική αντωνυμία
Post	ταχυδρομείο
Postfach	θυρίδα
Postkarte	καρτ ποστάλ
Potenzial	δυναμικό
Potsdam	Πότσδαμ
Pottasche	ποτάσσα
Pottwal	φάλαινα φυσητήρας
Pracht	μεγαλοπρέπεια
Prachttaucher	λαμπροβούτι
Prag	Πράγα
Praktikum	εξάσκηση
Praseodym	πρασεοδύμιο
Praxis	πράξη
Prediger	ιεροκήρυκας
Predigt	κήρυγμα
Preis	τιμή
Preiselbeere	κόκκινο μύρτιλλο
Premiere	πρεμιέρα
Presse	τύπος
Pressekonferenz	συνέντευξη τύπου
Preuße	Πρώσος
Preußen	Πρωσία
Pridnestrowien	Υπερδνειστερία
Priester	ιερέας
Priesterin	ιέρεια
Primzahl	πρώτος αριθμός
Prinz	πρίγκιπας
Prinzessin	πριγκίπισσα
Privatbesitz	ιδιοκτησία
Privateigentum	ιδιοκτησία
Privatisierung	ιδιωτικοποίηση
Probe	πρόβα
Probezeit	δοκιμαστικός
Problem	πρόβλημα
Produkt	προϊόν
Produktion	παραγωγή
Produktivität	παραγωγικότητα
Produzent	παραγωγός
Professor	καθηγητής
Profiteur	εκμεταλλευτής
Prognathie	προγναθισμός
Programm	πρόγραμμα
Programmierer	προγραμματιστής
Programmiererin	προγραμματίστρια
Programmiersprache	γλώσσα προγραμματισμού
Programmierung	προγραμματισμός
Prokrastination	αναβλητικότητα
Prokrustesbett	προκρούστειος κλίνη
Promenade	δεντροφυτεμένος δρόμος
Prometheus	Προμηθέας
Promethium	προμήθειο
Pronomen	αντωνυμία
Propaganda	προπαγάνδα
Propan	προπάνιο
Proparoxytonon	προπαροξύτονος
Propeller	προπέλα
Prophet	προφήτης
Propionsäure	προπιονικό οξύ
Prosa	πεζογραφία
Prostituierte	πόρνη
Prostitution	πορνεία
Protactinium	πρωτακτίνιο
Protagonist	πρωταγωνιστής
Protein	πρωτεΐνη
Protest	διαμαρτυρία
Protestantismus	προτεσταντισμός
Protokoll	πρωτόκολλο
Proton	πρωτόνιο
Provence	Προβηγκία
Provinz	επαρχία
Provinzler	επαρχιώτης
Provinzstadt	επαρχιακός
Prozent	el-Latn
Prozess	διαδικασία
Prozession	συνοδεία
Prozessor	επεξεργαστής
Pruße	Προύσος
Präambel	προοίμιο
Prädator	αρπακτικό
Prädikat	βαθμός
Präfix	πρόθημα
Präposition	πρόθεση
Präsentation	παρουσίαση
Präsident	πρόεδρος
Prüfröhrchen	σωλήνας δειγματοληψίας
Prüfung	έλεγχος
Psalm	ψαλμός
Pseudowissenschaft	ψευδοεπιστήμη
Psi	ψι
Psyche	ψυχή
Psychiater	ψυχίατρος
Psychiatrie	ψυχιατρική
Psychologe	ψυχολόγος
Psychologie	ψυχολογία
Psychologin	ψυχολόγος
Psychopath	ψυχοπαθής
Psychopharmakon	ψυχοφάρμακο
Psychose	ψύχωση
Psychotherapie	ψυχοθεραπεία
Pubertät	εφηβεία
Publizist	δημοσιογράφος
Puerto Rico	Πουέρτο Ρίκο
Puff	μπουρδέλο
Pullover	πουλόβερ
Puls	σφυγμός
Pulsar	πάλσαρ
Pulver	σκόνη
Puma	πούμα
Punkt	σημείο
Punsch	ποντς
Puppe	κούκλα
Putsch	πραξικόπημα
Putztuch	πανί
Puzzle	παζλ
Pyjama	πιτζάμα
Pyramide	πυραμίδα
Pyrenäen	Πυρηναία
Pyrolyse	πυρόλυση
Pyrrhussieg	πύρρεια νίκη
Pädagoge	παιδαγωγός
Pädagogik	παιδαγωγική
Pädagogin	παιδαγωγός
Pädiatrie	παιδιατρική
Pädophilie	παιδοφιλία
Päpstin	πάπισσα
Pünktlichkeit	ακρίβεια
Quadrat	τετράγωνο
Quadratkilometer	τετραγωνικό χιλιόμετρο
Quadratmeter	τετραγωνικό μέτρο
Quadratwurzel	τετραγωνική ρίζα
Qual	μαρτύριο
Qualität	ποιότητα
Qualle	μέδουσα
Quarantäne	καραντίνα
Quark	τυρόπηγμα
Quark	κουάρκ
Quarz	χαλαζίας
Quasar	κβάζαρ
Quecksilber	υδράργυρος
Quelle	πηγή
Quellwasser	πηγαίος
Querbalken	διαδοκίδα
Querlüftung	εγκάρσιος εξαερισμός
Quinoa	κινόα
Quito	Κίτο
Quitte	κυδωνιά
Quizshow	τηλεπαιχνίδι
Quorum	απαρτία
Quotient	πηλίκο
Québec	Κεμπέκ
Rabatt	έκπτωση
Rabbiner	ραβίνος
Rabe	κοράκι
Rache	εκδίκηση
Rad	ρόδα
Radar	ραντάρ
Radiant	ακτίνιο
Radiergummi	γομολάστιχα
Radieschen	ραπάνι
Radikalismus	ριζοσπαστισμός
Radio	ραδιόφωνο
Radioaktivität	ραδιενέργεια
Radioteleskop	ραδιοτηλεσκόπιο
Radium	ράδιο
Radon	ραδονιο
Radsport	ποδηλασία
Raffinerie	διυλιστήριο
Rahm	ανθόγαλα
Rakete	πύραυλος
Rallye	ράλι
Ramadan	ραμαζάνι
Ramme	αμνάδα
Rand	άκρη
Rande	παντζάρι
Randgruppe	περιθωριακή
Rangierbahnhof	σταθμός διαλογής
Rasen	γκαζόν
Rasiermesser	ξυράφι
Rasse	ράτσα
Rassismus	ρατσισμός
Rat	συμβούλιο
Rathaus	δημαρχείο
Ratlosigkeit	αμηχανία
Ratschlag	συμβουλή
Ratte	αρουραίος
Rauch	καπνός
Raucher	καπνιστής
Rauke	ρόκα
Raumluft	αέρας δωματίου
Raumschiff	διαστημόπλοιο
Raupe	κάμπια
Reagenzglas	δοκιμαστικός σωλήνας
Reaktion	αντίδραση
Reaktor	αντιδραστήρας
Rebell	επαναστάτης
Rebhuhn	πέρδικα
Rechenschieber	λογαριθμικός κανόνας
Rechner	υπολογιστής
Rechnung	λογαριασμός
Recht	δίκαιο
Rechte	δεξιά
Rechteck	ορθογώνιο παραλληλόγραμμο
Rechtsanwalt	δικηγόρος
Rechtsfolge	έννομη συνέπεια
Rechtsgeschäft	δικαιοπραξία
Rechtshandlung	έννομη πράξη
Recycling	ανακύκλωση
Rede	ομιλία
Redefreiheit	ελευθερία
Reden ist Silber, Schweigen ist Gold	η σιωπή είναι χρυσός
Redensart	ιδιωματισμός
Redeteil	μέρος του λόγου
Redewendung	έκφραση
Reduktion	μείωση
Reede	ράδα
Reeder	εφοπλιστής
Reederei	εφοπλιστικός
Referat	έκθεση
Referendum	δημοψήφισμα
Referenz	αναφορά
Reform	μεταρρύθμιση
Reformation	Μεταρρύθμιση
Refrain	επωδός
Regal	ράφι
Regel	κανόνας
Regelung	ρύθμιση
Regen	βροχή
Regenbogen	ουράνιο τόξο
Regeneration	αναγέννηση
Regensburg	Ρέγκενσμπουργκ
Regenschauer	μπόρα
Regenschirm	ομπρέλα
Regentag	βροχερός
Regentonne	στέρνα
Regenwetter	βροχερός καιρός
Regenwurm	γεωσκώληκας
Reggae	ρέγκε
Regierung	κυβέρνηση
Regierungschef	αρχηγός
Regime	καθεστώς
Regiment	σύνταγμα
Regisseur	σκηνοθέτης
Register	ευρετήριο
Reh	ζαρκάδι
Reibkäse	τυρί
Reibung	τριβή
Reich	βασίλειο
Reich der Mitte	Κίνα
Reichstag	Ράιχσταγκ
Reif	πάχνη
Reifen	λάστιχο
Reihe	γραμμή
Reihenfolge	σειρά
Reiher	ερωδιός
Reim	ομοιοκαταληξία
Reis	ρύζι
Reise	ταξίδι
Reisebeschreibung	οδοιπορικό
Reisebüro	ταξιδιωτικό γραφείο
Reiter	ιππέας
Reithose	κιλότα
Reißverschluss	φερμουάρ
Rekord	ρεκόρ
Relation	σχέση
Relativitätstheorie	θεωρία της σχετικότητας
Relief	ανάγλυφο
Religion	θρησκεία
Relikt	απομεινάρι
Reling	παραπέτο
Renaissance	Αναγέννηση
Renke	κορέγονος
Rente	σύνταξη
Rentier	τάρανδος
Rentner	συνταξιούχος
Reparation	αποζημίωση
Reporter	ρεπόρτερ
Republik	δημοκρατία
Republik Albanien	Αλβανία
Republik Angola	Δημοκρατία της Αγκόλας
Republik Armenien	Δημοκρατία της Αρμενίας
Republik Aserbaidschan	Αζερμπαϊτζανική Δημοκρατία
Republik Bolivien	Δημοκρατία της Βολιβίας
Republik Bulgarien	Δημοκρατία της Βουλγαρίας
Republik China	Δημοκρατία της Κίνας
Republik Finnland	Φινλανδική Δημοκρατία
Republik Haiti	Δημοκρατία της Αϊτής
Republik Irak	Δημοκρατία του Ιράκ
Republik Kongo	Δημοκρατία του Κονγκό
Republik Korea	Δημοκρατία της Κορέας
Republik Malta	Δημοκρατία της Μάλτας
Republik Polen	Δημοκρατία της Πολωνίας
Republik Serbien	Δημοκρατία της Σερβίας
Republik Zypern	Κυπριακή Δημοκρατία
Republik der Philippinen	Δημοκρατία των Φιλιππίνων
Republik Österreich	Δημοκρατία της Αυστρίας
Republikaner	ρεπουμπλικάνος
Reservierung	κράτηση
Resignation	απελπισία
Resonanz	απήχηση
Respekt	σεβασμός
Respektlosigkeit	ασέβεια
Rest	υπόλοιπο
Restaurant	εστιατόριο
Restauration	αναστύλωση
Retsina	ρετσίνα
Rettung	διάσωση
Rettungswagen	ασθενοφόρο
Revolte	στάση
Revolution	επανάσταση
Revolver	περίστροφο
Rezept	συνταγή
Rezeption	ρεσεψιόν
Rezession	ύφεση
Rhabarber	ραβέντι
Rhein	Ρήνος
Rheinanke	κορέγονος
Rheinland	Ρηνανία
Rheinland-Pfalz	Ρηνανία-Παλατινάτο
Rhenium	ρήνιο
Rheuma	ρευματισμοί
Rhodium	ρόδιο
Rhone	Ροδανός
Rhotazismus	ρωτακισμός
Rhythmus	ρυθμός
Riad	Ριάντ
Ribosom	ριβόσωμα
Richter	δικαστής
Richterin	δικαστής
Richtlinie	γραμμή
Richtung	κατεύθυνση
Ried	καλάμι
Riff	ύφαλος
Riga	Ρίγα
Rind	βόδι
Rinderbraten	ψητό μοσχάρι
Rindfleisch	βοδινό κρέας
Ring	δαχτυλίδι
Ringfinger	παράμεσος
Rinne	αυλάκι
Rio	Ρίο
Rio de Janeiro	Ρίο ντε Τζανέιρο
Rippchen	παϊδάκι
Rippe	πλευρό
Risiko	κίνδυνος
Ritter	ιππότης
Ritual	τελετουργικό
Riyal	ριγιάλ
Robbe	φώκια
Roboter	ρομπότ
Rochen	σαλάχι
Rock	ροκ
Rock	φούστα
Rocken	ρόκα
Rodelschlitten	ελκηθράκι
Rogen	αυγοτάραχο
Roggen	σίκαλη
Rohbau	γιαπί
Rohrzange	κάβουρας
Rohstoff	πρώτη ύλη
Rollstuhl	αναπηρικό καροτσάκι
Rolltreppe	κυλιόμενη σκάλα
Rom	Ρώμη
Roman	μυθιστόρημα
Romantik	ρομαντισμός
Rose	τριαντάφυλλο
Rosenkranz	ροζάριο
Rosine	σταφίδα
Rosmarin	δεντρολίβανο
Ross	άτι
Rost	σκουριά
Rostock	Ρόστοκ
Roséwein	ροζέ κρασί
Rot	κόκκινο
Rote Bete	παντζάρι
Rote Karte	κόκκινη κάρτα
Rote Rübe	παντζάρι
Rotes Kreuz	Ερυθρός Σταυρός
Rotes Meer	Ερυθρά Θάλασσα
Rotkehlchen	κοκκινολαίμης
Rotkäppchen	Κοκκινοσκουφίτσα
Rotterdam	Ρότερνταμ
Rotwein	κόκκινο κρασί
Roulette	ρουλέτα
Route	διαδρομή
Ruanda	Ρουάντα
Rubel	ρούβλι
Rubidium	ρουβίδιο
Rubikon	Ρουβίκωνας
Rubin	ρουμπίνι
Rucksack	σακίδιο
Rucola	ρόκα
Rucola	ρόκα
Ruder	κουπί
Rudern	κωπηλασία
Rugby	ράγκμπι
Ruhe	ησυχία
Ruhm	δόξα
Ruhr	Ρουρ
Ruhrgebiet	κοιλάδα του Ρουρ
Ruine	ερείπιο
Rum	ρούμι
Rumpf	σκάφος
Rumänien	Ρουμανία
Rundblick	πανόραμα
Rune	ρούνος
Rupia	ῥύπος
Rupie	ρουπία
Russe	Ρώσος
Russin	Ρωσίδα
Russisch	ρωσικα
Russische Föderation	Ρωσική Ομοσπονδία
Russland	Ρωσία
Ruth	Ρουθ
Ruthenium	ρουθήνιο
Rutherfordium	ραδερφόρντιο
Rutsche	τσουλήθρα
Ruß	αιθάλη
Rächer	εκδικητής
Rätsel	αίνιγμα
Räuber	ληστής
Réunion	Ρεϋνιόν
Römer	Ρωμαίος
Römisches Reich	Αρχαία Ρώμη
Röntgenstrahlung	ακτίνες Χ
Röteln	ερυθρά
Rübe	τεύτλο
Rückbildung	αναδρομικός σχηματισμός
Rückblende	αναδρομή
Rücken	πλάτη
Rückenmark	νωτιαίος μυελός
Rückentlehnung	αντιδάνειο
Rückkehr	γυρισμός
Rückruf	ανάκληση
Rücktritt	παραίτηση
Rückzug	υποχώρηση
Rührei	αβγά
SMS	SMS
Saal	αίθουσα
Saar	Σάαρ
Saarbrücken	Σααρμπρύκεν
Saarland	Σάαρ
Saatkrähe	χαβαρόνι
Sabotage	σαμποτάζ
Sachbuch	βιβλίο
Sache	πράγμα
Sachsen	Σαξονία
Sachsen-Anhalt	Σαξωνία-Άνχαλτ
Sachverständiger	ειδήμων
Sadismus	σαδισμός
Sadist	σαδιστής
Safran	ζαφορά
Saft	χυμός
Sahara	Σαχάρα
Sahne	ανθόγαλα
Saison	σεζόν
Saite	χορδή
Saiteninstrument	έγχορδο
Sakrament	μυστήριο
Sakrileg	ιεροσυλία
Sakristei	σκευοφυλάκιο
Salamander	σαλαμάνδρα
Salami	σαλάμι
Salat	μαρούλι
Salatschleuder	στραγγιστήρι
Salbe	αλοιφή
Salbei	φασκομηλιά
Salmonelle	σαλμονέλα
Salomonen	Νήσοι Σολομώντα
Salpetersäure	νιτρικό οξύ
Salve	ομοβροντία
Salz	αλάτι
Salzburg	Σάλτσμπουργκ
Salzsäure	υδροχλωρικό οξύ
Samara	Σαμάρα
Samara	Σαμάρα
Samariter	Σαμαρείτης
Samarium	σαμάριο
Samba	σάμπα
Sambia	Ζάμπια
Same	σπόρος
Samen	σπόρος
Samenzelle	σπερματοζωάριο
Sammeln	συλλογή
Sammlung	συλλογή
Samoa	Σαμόα
Samowar	σαμοβάρι
Samstag	Σάββατο
Samt	βελούδο
Samuel	Σαμουήλ
Samurai	σαμουράι
San Marino	Άγιος Μαρίνος
Sand	άμμος
Sandale	πέδιλο
Sandbank	ύφαλος
Sandstein	ψαμμίτης
Sanduhr	κλεψύδρα
Sandwich	σάντουιτς
Sangria	σαγκρία
Sankt Petersburg	Αγία Πετρούπολη
Santiago de Chile	Σαντιάγο
Santo Domingo	Σάντο Ντομίγκο
Saphir	ζαφείρι
Sarajevo	Σαράγεβο
Sarazene	σαρακηνόσ
Sardelle	γαύρος
Sardine	σαρδέλα
Sardinien	Σαρδηνία
Sarg	φέρετρο
Sarin	σαρίν
Sarkasmus	σαρκασμός
Sarkophag	σαρκοφάγος
Saskatchewan	Σασκάτσουαν
Satan	σατανάς
Satanismus	σατανισμός
Satellit	δορυφόρος
Satire	σάτιρα
Sattel	σέλα
Saturn	Κρόνος
Satz	πρόταση
Satz des Pythagoras	πυθαγόρειο θεώρημα
Satzende	πρόταση
Satzzeichen	σημείο
Sauberkeit	καθαριότητα
Saubohne	κουκί
Saudi-Arabien	Σαουδική Αραβία
Sauerdorn	βερβερίδα
Sauerkirsche	βυσσινιά
Sauerstoff	οξυγόνο
Sauerteig	μεταλευτής
Sauna	σάουνα
Savanne	σαβάνα
Save	Σάβα
Savoyen	Σαβοΐα
Saxophon	σαξόφωνο
Saxophonist	σαξοφωνίστας
Scandium	σκάνδιο
Schach	σκάκι
Schachbrett	σκακιέρα
Schachtel	κουτί
Schaden	ζημιά
Schadenersatz	αποζημίωση
Schadenfreude	χαιρεκακία
Schaffleisch	πρόβειο κρέας
Schaffner	εισπράκτορας
Schafgarbe	αχιλλέα
Schafott	ικρίωμα
Schakal	τσακάλι
Schal	κασκόλ
Schale	φλούδα
Schallplattensammlung	δισκοθήκη
Schaltjahr	δίσεκτος
Scham	ντροπή
Schande	ντροπή
Schanghai	Σαγκάη
Schatten	σκιά
Schatulle	κουτί
Schatz	θησαυρός
Schauder	ανατριχίλα
Schauer	μπόρα
Schaufel	φτυάρι
Schaufenster	βιτρίνα
Schaum	αφρός
Schauspiel	θεατρικό έργο
Schauspieler	ηθοποιός
Schauspielerei	ηθοποιία
Schauspielerin	ηθοποιός
Scheck	επιταγή
Scheibe	δίσκος
Scheibenwischer	υαλοκαθαριστήρας
Scheide	θήκη
Scheidung	διαζύγιο
Scheiterhaufen	πυρά
Scheitern	αποτυχία
Scheiße	σκατά
Schellfisch	βακαλάος
Schere	ψαλίδι
Scheu	ντροπή
Scheune	αχυρώνας
Schicht	στρώμα
Schicksal	μοίρα
Schiedsrichter	διαιτητής
Schienbein	καλάμι
Schiff	καράβι
Schiffbruch	ναυάγιο
Schiffbrüchiger	ναυαγός
Schiffseigner	εφοπλιστής
Schild	ασπίδα
Schildkröte	χελώνα
Schilling	σελίνι
Schimmel	μούχλα
Schimpanse	χιμπατζής
Schinken	ζαμπόν
Schippe	φτυάρι
Schirmherrschaft	αιγίδα
Schisma	σχίσμα
Schizophrenie	σχιζοφρένεια
Schlacht	μάχη
Schlachten	σφαγή
Schlachtfeld	πεδίο μάχης
Schlachtschiff	θωρηκτό
Schlaf	ύπνος
Schlaflied	νανούρισμα
Schlaflosigkeit	αϋπνία
Schlafrock	ρόμπα
Schlafsack	υπνόσακος
Schlafzimmer	κρεβατοκάμαρα
Schlagloch	λακκούβα
Schlagzeile	πρωτοσέλιδο
Schlamm	λάσπη
Schlange	φίδι
Schlaumeier	εξυπνάκιας
Schleim	βλέννα
Schleimhaut	βλεννογόνος
Schlepper	ρυμουλκό πλοίο
Schlesien	Σιλεσία
Schleswig-Holstein	Σλέσβιχ-Χολστάιν
Schleuder	σφεντόνα
Schließung	κλείσιμο
Schlitten	έλκηθρο
Schlittschuh	παγοπέδιλο
Schloss	κλειδαριά
Schlosser	μηχανικός
Schlucht	φαράγγι
Schluchzer	λυγμός
Schluck	γουλιά
Schlussfolgerung	συμπέρασμα
Schläfe	κρόταφος
Schläfrigkeit	υπνηλία
Schlüssel	κλειδί
Schlüsselanhänger	κλειδοθήκη
Schlüsselbein	κλείδα
Schmerz	πόνος
Schmerzmittel	παυσίπονο
Schmetterling	πεταλούδα
Schmidt	Σιδεράκης
Schmied	σιδεράς
Schmuggel	λαθρεμπόριο
Schmuggler	λαθρέμπορος
Schmutz	βρομιά
Schnabel	ράμφος
Schnabeltier	πλατύποδας
Schnalle	αγκράφα
Schnappschuss	στιγμιότυπο
Schnaps	ρακί
Schnecke	σαλιγκάρι
Schneckenhaus	καβούκι
Schnee	χιόνι
Schneeball	χιονόμπαλα
Schneebesen	αναδευτήρας
Schneefall	χιονόπτωση
Schneeflocke	νιφάδα
Schneeglöckchen	γάλανθος
Schneemann	χιονάνθρωπος
Schneepflug	εκχιονιστήρας
Schneeschuh	χιονοπέδιλο
Schneesturm	χιονοθύελλα
Schneewittchen	Χιονάτη
Schneider	ράφτης
Schneiderei	ραφείο
Schneiderin	ράφτρα
Schneidersitz	σταυροπόδι
Schneiderstube	ραφείο
Schnellimbiss	ταχυφαγείο
Schnickschnack	κουταμάρες
Schnitt	κοψιά
Schnitte	φέτα
Schnittlauch	σχοινόπρασο
Schnittpunkt	τομή
Schnittwunde	κοψιά
Schnuller	πιπίλα
Schnupfen	συνάχι
Schnurrbart	μουστάκι
Schokolade	σοκολάτα
Scholle	βατίς
Schoner	γολέτα
Schornsteinfeger	καπνοδοχοκαθαριστής
Schotte	Σκωτσέζος
Schottin	Σκωτσέζα
Schottland	Σκωτία
Schrank	ντουλάπα
Schraubendreher	κατσαβίδι
Schraubenmutter	παξιμάδι
Schraubenschlüssel	κλειδί
Schraubenzieher	κατσαβίδι
Schrei	κραυγή
Schreiben	γράψιμο
Schreibmaschine	γραφομηχανή
Schreibtisch	γραφείο
Schreihals	φωνακλάς
Schreiner	ξυλουργός
Schriftsteller	συγγραφέας
Schriftstellerin	συγγραφέας
Schriftverkehr	αλληλογραφία
Schriftwechsel	αλληλογραφία
Schritt	βήμα
Schrott	σκραπ
Schrottpresse	σιδερικά
Schrödingers Katze	γάτα
Schubkarre	καροτσάκι
Schublade	συρτάρι
Schuh	παπούτσι
Schuhmacher	υποδηματοποιός
Schuhschnabel	φαλαινοκέφαλος
Schuld	ενοχή
Schule	σχολείο
Schuljahr	έτος
Schulter	ώμος
Schulterblatt	ωμοπλάτη
Schulweg	δρόμος
Schuppe	λέπι
Schuster	τσαγκάρης
Schutz	προστασία
Schutzengel	φυλακάγγελος
Schutzheiliger	πολιούχος
Schutzhütte	καταφύγιο
Schutzmaske	προστασία
Schutzpatron	προστάτης
Schwaben	Σουηβία
Schwager	κουνιάδος
Schwalbe	χελιδόνι
Schwamm	σφουγγάρι
Schwan	κύκνος
Schwanengesang	κύκνειο άσμα
Schwangere	έγκυος
Schwangerschaftstest	τεστ εγκυμοσύνης
Schwankung	διακύμανση
Schwanz	ουρά
Schwarm	σμήνος
Schwarz	μαύρο
Schwarzer	μαύρος
Schwarzerle	σκλήθρο
Schwarzes Loch	μαύρη τρύπα
Schwarzes Meer	Μαύρη Θάλασσα
Schwarzmarkt	μαύρη αγορά
Schwarzspecht	μαυροτσικλιτάρα
Schwarzwald	Μέλανας Δρυμός
Schwede	Σουηδός
Schweden	Σουηδία
Schwedin	Σουηδή
Schwedisch	σουηδικά
Schwefel	θείο
Schwefelsäure	θειικό οξύ
Schweifstern	κομήτης
Schweigen	σιωπή
Schwein	γουρούνι
Schweinefleisch	χοιρινό
Schweiz	Ελβετία
Schweizerdeutsch	ελβετικά γερμανικά
Schweizerische Eidgenossenschaft	Ελβετική Συνομοσπονδία
Schweiß	ιδρώτας
Schweißer	οξυγονοσυγκολλητής
Schwelle	κατώφλι
Schwerin	Σβέριν
Schwerkraft	βαρύτητα
Schwert	ξίφος
Schwertfisch	ξιφίας
Schwester	αδελφή
Schwiegereltern	πεθερικά
Schwiegermutter	πεθερά
Schwiegersohn	γαμπρός
Schwiegertochter	νύφη
Schwiegervater	πεθερός
Schwierigkeit	δυσκολία
Schwimmbad	κολυμβητήριο
Schwimmbecken	πισίνα
Schwimmen	κολύμβηση
Schwimmer	κολυμβητής
Schwimmerin	κολυμβήτρια
Schwur	όρκος
Schwägerin	κουνιάδα
Schwätzchen	κουβεντούλα
Schädel	κρανίο
Schärpe	εσάρπα
Schönes	ωραίο
Schönheit	ομορφιά
Schöpfer	δημιουργός
Schüchternheit	ντροπαλότητα
Schüler	μαθητής
Science-Fiction	επιστημονική φαντασία
Seattle	Σιάτλ
Secharja	Ζαχαρίας
Sechs	έξι#Substantiv, n, indeklinabel
Sechseck	εξάγωνο
See	θάλασσα
See	λίμνη
Seeadler	θαλασσαετός
Seebarsch	λαβράκι
Seefahrer	θαλασσοπόρος
Seegang	τρικυμιώδης θάλασσα
Seehecht	μερλούκιος ο γνήσιος
Seehund	φώκια
Seeigel	αχινός
Seekrankheit	ναυτία
Seelachs	κιτρινοπολλάκιο
Seele	ψυχή
Seelenfrieden	γαλήνη
Seelengröße	μεγαλοψυχία
Seelenruhe	γαλήνη της ψυχής
Seemacht	ναυτική δύναμη
Seemann	ναύτης
Seepferdchen	ιππόκαμπος
Seestern	αστερίας
Seeteufel	πεσκαντρίτσα
Seezunge	γλώσσα
Segel	πανί
Segelschiff	ιστιοφόρο
Sehenswürdigkeit	αξιοθέατο
Sehne	τένοντας
Sehnerv	οπτικό νεύρο
Sehnsucht	λαχτάρα
Seide	μετάξι
Seidenschwanz	βομβυκίλλα
Seife	σαπούνι
Seil	σκοινί
Seilbahn	τελεφερίκ
Sein	ύπαρξη
Seine	Σηκουάνας
Seismologie	σεισμολογία
Seite	πλευρά
Sekret	έκκριμα
Sekretion	έκκριση
Sekunde	δευτερόλεπτο
Selbstlaut	φωνήεν
Selbstlüftung	αυτόματος αερισμός
Selbstmord	αυτοκτονία
Selbstmörder	αυτόχειρας
Selbstporträt	αυτοπροσωπογραφία
Selbstversorgung	αυτάρκεια
Selbstwertgefühl	αίσθημα
Selen	σελήνιο
Selfie	αυτοφωτογράφιση
Sellerie	σέλινο
Semantik	σημασιολογία
Semester	εξάμηνο
Senat	γερουσία
Sendung	εκπομπή
Senegal	Σενεγάλη
Senf	μουστάρδα
Senfgas	αέριο μουστάρδας
Senior	ηλικιωμένος
Sense	κόσα
Sensenmann	χάρος
Seoul	Σεούλ
Septuaginta	εβδομήκοντα
Serbien	Σερβία
Serbien und Montenegro	Σερβία και Μαυροβούνιο
Serbisch	σερβικά
Serie	σειρά
Serotonin	σεροτονίνη
Serpentin	σερπεντίνης
Server	εξυπηρετητής
Service	σερβίτσιο
Serviette	πετσέτα
Sesam	σουσαμιά
Sessel	πολυθρόνα
Seuche	επιδημία
Sevilla	Σεβίλλη
Sewastopol	Σεβαστούπολη
Sexismus	σεξισμός
Sexspielzeug	ερωτικό βοήθημα
Sexstellung	στάσεις στο σεξ
Sexualität	σεξουαλικότητα
Seychellen	Σεϋχέλλες
Shampoo	σαμπουάν
Sherry	σέρι
Shintoismus	σίντο
Sibirien	Σιβηρία
Sichel	δρεπάνι
Sicherheitsgurt	ζώνη ασφαλείας
Sicherheitsnadel	παραμάνα
Sieb	σουρωτήρι
Siebenbürgen	Τρανσυλβανία
Siedler	άποικος
Siedlung	συνοικία
Sieg	νίκη
Siegel	σφραγίδα
Siegellack	βουλοκέρι
Siegen	Ζίγκεν
Sieger	νικητής
Siel	ιλυοδόχη
Sierra Leone	Σιέρα Λεόνε
Silbe	συλλαβή
Silbenschrift	συλλαβογραφία
Silbentrennung	συλλαβισμός
Silber	αργυρος
Silizium	πυρίτιο
Silo	σιλό
Silvester	παραμονή πρωτοχρονιάς
Silvester	Σιλβέστρος
Silvesterparty	ρεβεγιόν
Simbabwe	Ζιμπάμπουε
Simferopol	Συμφερόπολη
Sindelfingen	Ζίντελφιγκεν
Sinfonie	συμφωνία
Singapur	Σιγκαπούρη
Singen	τραγούδισμα
Singular	ενικός
Sinn	αίσθηση
Sinter	πουρί
Sintflut	κατακλυσμός
Sinus	ημίτονο
Sinusitis	ιγμορίτιδα
Sirene	Σειρήνα
Sirup	σιρόπι
Sitar	σιτάρ
Sittich	παπαγαλίνα
Sitz	κάθισμα
Sitzung	συνεδρίαση
Sizilien	Σικελία
Skala	κλίμακα
Skalpell	νυστέρι
Skandal	σκάνδαλο
Skandinavien	Σκανδιναβία
Skeleton	σκέλετον
Skelett	σκελετός
Skepsis	σκεπτικισμός
Skeptizismus	σκεπτικισμός
Ski	σκι
Skispringen	άλμα με σκι
Skizze	σχέδιο
Sklave	δούλος
Sklavenhandel	δουλεμπόριο
Sklaverei	δουλεία
Sklavin	σκλάβα
Skopje	Σκόπια
Skorbut	σκορβούτο
Skorpion	σκορπιός
Skulptur	γλυπτό
Slang	αργκό
Slawe	Σλάβος
Slawisch	σλαυικός
Slowake	Σλοβάκος
Slowakei	Σλοβακία
Slowakisch	σλοβακικά
Slowenien	Σλοβενία
Smaragd	σμαράγδι
Smartphone	smartphone
Smoking	σμόκιν
Snowboarder	σνόουμπορντερ
Socke	κάλτσα
Sodbrennen	καούρα
Sofa	καναπές
Sofia	Σόφια
Software	λογισμικό
Sohn	γιος
Soja	σόγια
Soldat	στρατιώτης
Soldatensprache	στρατιωτική αργκό
Solidarität	αλληλεγγύη
Soma	σώμα
Somalia	Σομαλία
Sommer	καλοκαίρι
Sommersprosse	φακίδα
Sommerzeit	θερινή ώρα
Sonderfall	εξαίρεση
Sondierung	βολιδοσκόπηση
Sonett	σονέτο
Sonne	ήλιος
Sonnenblumenöl	ηλιέλαιο
Sonnenbrand	ηλιακό έγκαυμα
Sonnenbrille	γυαλιά ηλίου
Sonnencreme	αντηλιακή κρέμα
Sonnenfinsternis	έκλειψη του ηλίου
Sonnenfleck	ηλιακή κηλίδα
Sonnenschein	φως του ήλιου
Sonnensegel	ηλιακό ιστίο
Sonnenstrahl	ηλιαχτίδα
Sonnensystem	ηλιακός
Sonnenuhr	ηλιακό ρολόι
Sonnenuntergang	ηλιοβασίλεμα
Sonnenwende	ηλιοστάσιο
Sonntag	Κυριακή
Sophistik	σοφιστική
Sorbisch	Λουστιανός-Σέρβος
Sorge	ανησυχία
Sorgerecht	επιμέλεια
Sorghum	σόργο
Sotschi	Σότσι
Soufflé	σουφλέ
Soundtrack	σάουντρακ
Sowchos	σοβχόζ
Sowjetunion	Σοβιετική Ένωση
Sozialdemokrat	σοσιαλδημοκράτης
Sozialdemokratie	σοσιαλδημοκρατία
Sozialdemokratin	σοσιαλδημοκράτισσα
Sozialismus	σοσιαλισμός
Sozialistische Republik Vietnam	Σοσιαλιστική Δημοκρατία του Βιετνάμ
Soziolinguistik	κοινωνιογλωσσολογία
Soziologie	κοινωνιολογία
Soße	σάλτσα
Spaghetti	σπαγκέτι
Spalte	ρωγμή
Spandau	Σπάνταου
Spanien	Ισπανία
Spanier	Ισπανός
Spanisch	ισπανικά
Spannung	τάση
Spargel	ασπάραγος
Sparta	Σπάρτη
Spaten	φτυάρι
Spatz	σπουργίτης
Spaziergang	βόλτα
Spaß	διασκέδαση
Specht	δρυοκολάπτης
Speer	ακόντιο
Speerwurf	ακοντισμός
Speiche	ακτίνα
Speichel	σάλιο
Speierling	σουρβιά η οικιακή
Speise	φαγητό
Speiseeis	παγωτό
Speisekarte	κατάλογος
Speiseröhre	οισοφάγος
Spektroskop	φασματοσκόπιο
Spektrum	φάσμα
Spelunke	καταγώγιο
Speläologe	σπηλαιολόγος
Sperber	ξεφτέρι
Sperling	σπουργίτης
Sperlingskauz	σπουργιτόγλαυκα
Sperma	σπέρμα
Spermium	σπερματοζωάριο
Speyer	Σπάιερ
Spezialist	ειδικός
Spezialität	ειδικότητα
Sphinkter	σφιγκτήρας
Sphäre	σφαίρα
Spickzettel	σκονάκι
Spiegel	καθρέφτης
Spiel	παιχνίδι
Spieler	παίκτης
Spielplatz	παιδική χαρά
Spielzeug	παιχνίδι
Spieß	σούβλα
Spinat	σπανάκι
Spindel	αδράχτι
Spinne	αράχνη
Spinnennetz	ιστός
Spinnrad	ροδάνι
Spinnwebe	ιστός
Spion	κατάσκοπος
Spionage	κατασκοπεία
Spitze	δαντέλα
Spitzhacke	κασμάς
Spitzname	παρατσούκλι
Spontaneität	αυθορμητισμός
Sport	αθλητισμός
Sportler	αθλητής
Sprache	γλώσσα
Sprachenvielfalt	γλωσσική πολυμορφία
Sprachwissenschaft	γλωσσολογία
Spree	Σπρέε
Sprengstoff	εκρηκτική ύλη
Sprichwort	παροιμία
Springbrunnen	σιντριβάνι
Springer	ίππος
Spritze	σύριγγα
Sprössling	βλαστάρι
Sprühregen	ψιλόβροχο
Spule	πηνίο
Spur	ίχνος
Spätantike	ύστερη αρχαιότητα
Spätherbst	φθινόπωρο
Spülkasten	καζανάκι
Squash	σκουός
Sri Lanka	Σρι Λάνκα
St. Kitts und Nevis	Άγιος Χριστόφορος και Νέβις
St. Lucia	Αγία Λουκία
St. Vincent und die Grenadinen	Άγιος Βικέντιος και Γρεναδίνες
Staat	κράτος
Staat Israel	Κράτος του Ισραήλ
Staatsangehöriger	υπήκοος
Staatsangehörigkeit	υπηκοότητα
Staatsanwalt	εισαγγελέας
Staatsbürgerschaft	υπηκοότητα
Staatsstreich	πραξικόπημα
Stab	ραβδί
Stabhochsprung	άλμα επί κοντώ
Stachelbeere	λαγοκέρασο
Stachelschwein	ακανθόχοιρος
Stadion	στάδιο
Stadt	πόλη
Stadtstaat	πόλη-κράτος
Stadtteil	συνοικία
Stadtviertel	συνοικία
Staffelei	καβαλέτο
Stahl	ατσάλι
Stahlbeton	οπλισμένο σκυρόδεμα
Stahlwerk	χαλυβουργείο
Stalking	παρενόχληση
Stall	στάβλος
Stamm	κορμός
Stammkunde	θαμώνας
Standesamt	ληξιαρχείο
Standesbeamter	ληξίαρχος
Standesbeamtin	ληξίαρχος
Stange	κοντάρι
Stapel	στοίβα
Stapellauf	καθέλκυση
Star	ψαρόνι
Start	αφετηρία
Startlinie	αφετηρία
Stasi	Στάζι
Statistik	Στατιστική
Statue	άγαλμα
Status	κατάσταση
Status quo	καθεστώς
Staub	σκόνη
Staubsauger	ηλεκτρική σκούπα
Staudamm	φράγμα
Stearinsäure	στεαρικό οξύ
Steckdose	πρίζα
Steg	καβαλάρης
Steigbügel	αναβολέας
Steilhang	πλαγιά
Steilküste	ακτή
Stein	λίθος
Stein der Weisen	φιλοσοφική λίθος
Steinadler	χρυσαετός
Steinbock	αίγαγρος
Steinbruch	λατομείο
Steinbutt	καλκάνι
Steinfrucht	δρύπη
Steinkohle	λιθάνθρακας
Steinmarder	κουνάβι
Steinmetz	κτίστης
Steinzeit	Εποχή του Λίθου
Steißbein	κόκκυξ
Stempelkissen	ταμπόν
Steppe	στέπα
Sterbehilfe	ευθανασία
Stern	αστέρι
Sternbild	αστερισμός
Sternchen	αστερίσκος
Steroid	στεροϊδές
Stethoskop	στηθοσκόπιο
Stettin	Στσέτσιν
Steuer	φόρος
Steuerhinterziehung	φοροδιαφυγή
Steuermann	κυβερνήτης
Steuerzahler	φορολογούμενος
Steward	αεροσυνοδός
Stewardess	αεροσυνοδός
Stichsäge	σέγα
Stichwort	λήμμα
Stickstoff	άζωτο
Stiefbruder	ετεροθαλής αδελφός
Stiefel	μπότα
Stiefmutter	μητριά
Stiefmütterchen	πανσές
Stiefsohn	προγονός
Stieftochter	προγονή
Stiefvater	πατριός
Stieglitz	γαρδέλι
Stier	ταύρος
Stigma	στíγμα
Stil	ύφος
Stilistik	υφολογία
Stille	σιωπή
Stimmband	φωνητική χορδή
Stimme	φωνή
Stimmzettel	ψηφοδέλτιο
Stimulation	ερεθισμός
Stipendium	υποτροφία
Stirn	μέτωπο
Stockente	πρασινοκέφαλη
Stockfisch	γαϊδουρόψαρο
Stockholm	Στοκχόλμη
Stockwerk	όροφος
Stoff	ουσία
Stoffwechsel	μεταβολισμός
Stoiker	στοικός
Storch	πελαργός
Stoßstange	προφυλακτήρας
Strafe	ποινή
Strafverfolgung	δίωξη
Strahl	ακτίνα
Strahlung	ακτινοβολία
Stralsund	Στράλσουντ
Strand	παραλία
Strategie	στρατηγική
Stratosphäre	στρατόσφαιρα
Strauch	θάμνος
Strauß	μπουκέτο
Straßburg	Στρασβούργο
Straße	οδός
Straße von Hormus	Στενά του Ορμούζ
Straßenbahn	τραμ
Straßenkreuzung	διασταύρωση
Straßenverkehr	οδική κυκλοφορία
Streber	σπασίκλας
Streichholzschachtel	σπιρτόκουτο
Streichinstrument	έγχορδο όργανο με δοξάρι
Streife	περίπολος
Streifenwagen	περιπολικό
Streik	απεργία
Streit	καβγάς
Streitkraft	ένοπλες δυνάμεις
Stress	άγχος
Strickzeug	πλεκτό
Stringtheorie	Θεωρία Χορδών
Striptease	στριπτίζ
Stroh	άχυρο
Strohhut	ψάθινο καπέλο
Strom	ρεύμα
Stromboli	Στρόμπολι
Stromerzeugung	ηλεκτροπαραγωγή
Strontium	Στρόντιο
Strophe	στροφή
Strudel	δίνη
Struktur	δομή
Strumpf	κάλτσα
Strumpfhose	καλτσόν
Strychnin	στρυχνίνη
Strömung	ρεύμα
Student	φοιτητής
Studium	μελέτη
Stuhl	καρέκλα
Stuhlbein	καρεκλοπόδαρο
Stunde	ώρα
Stundensatz	αμοιβή
Sturm	θύελλα
Sturm im Wasserglas	πολύ κακό για το τίποτα
Sturmflut	φουσκονεριά
Stute	φοράδα
Stuttgart	Στουτγκάρδη
Styx	Στυξ
Städter	αστός
Städterin	αστή
Stärke	δύναμη
Stör	στουριόνι
Störung	διαταραχή
Stück	κομμάτι
Subjekt	υποκείμενο
Subkontinent	υποήπειρος
Subkultur	υποπολιτισμός
Substantiv	ουσιαστικό
Substantivierung	ουσιαστικοποίηση
Substanz	ουσία
Subtraktion	αφαίρεση
Suche	αναζήτηση
Sucht	εξάρτηση
Sudan	Σουδάν
Suffix	επίθημα
Sultan	σουλτάνος
Summand	προσθετέος
Summe	άθροισμα
Sumpf	έλος
Superheld	υπερήρωας
Superheldin	υπερηρωίδα
Superlativ	υπερθετικός
Supermarkt	σούπερ-μάρκετ
Supernova	υπερκαινοφανής
Supersymmetrie	υπερσυμμετρία
Supinum	σουπίνο
Suppe	σούπα
Sure	σουράτα
Suriname	Σουρινάμ
Surrealismus	υπερρεαλισμός
Susanne	Σουζάνα
Sushi	σούσι
Swasiland	Σουαζιλάνδη
Swimmingpool	πισίνα
Sydney	Σίδνεϊ
Syllogismus	συλλογισμός
Symbol	σύμβολο
Symmetrie	συμμετρία
Sympathie	συμπόνια
Symptom	σύμπτωμα
Synagoge	συναγωγή
Syndrom	σύνδρομο
Synekdoche	συνεκδοχή
Synkretismus	συγκρητισμός
Synonym	συνώνυμο
Syntax	σύνταξη
Synthese	σύνθεση
Syphilis	σύφιλη
Syrer	συριακός
Syrien	Συρία
System	σύστημα
Szene	σκηνή
Szylla	Σκύλλα
São Tomé und Príncipe	Σάο Τομέ και Πρίνσιπε
Säbel	σπαθί
Säge	πριόνι
Sänger	τραγουδιστής
Sängerin	τραγουδίστρια
Säugetier	θηλαστικό
Säugling	βρέφος
Säule	κίονας
Säure	οξύ
Säure-Base-Reaktion	αντίδραση οξέος-βάσης
Sölden	Ζέλντεν
Söldner	μισθοφόρος
Südafrika	Νότιος Αφρική
Südamerika	Νότια Αμερική
Süden	νότος
Südeuropa	Νότια Ευρώπη
Südkorea	Νότια Κορέα
Südküste	νότια ακτή
Südosteuropa	Νοτιοανατολική Ευρώπη
Südslawe	νότια Σλάβ
Südsudan	Νότιο Σουδάν
Südwesten	νοτιοδυτικά
Sünde	αμάρτημα
Sündenbock	αποδιοπομπαίος τράγος
Süßigkeit	γλύκισμα
Süßkartoffel	γλυκοπατάτα
Süßkirsche	κεράσι
Süßstoff	γλυκαντικό
Tabak	καπνός
Tabelle	πίνακας
Tablett	δίσκος
Tablette	χάπι
Tabu	ταμπού
Tachykardie	ταχυκαρδία
Taco	τάκος
Tadschikistan	Τατζικιστάν
Taekwondo	Τάε Κβον Ντο
Tafel	πλάκα
Tag	μέρα
Tagebuch	ημερολόγιο
Tagesausflug	εκδρομή
Tagesende	τέλος
Tagesordnung	διάταξη
Tagestour	εκδρομή
Tagundnachtgleiche	ισημερία
Tagung	συνέδριο
Taifun	τυφώνας
Taille	μέση
Taipeh	Ταϊπέι
Taiwan	Ταϊβάν
Taktik	τακτική
Taktstock	μπαγκέτα
Tal	κοιλάδα
Talg	ξίγκι
Taliban	Ταλιμπάν
Talk	τάλκης
Tallinn	Ταλίν
Tamburin	ντέφι
Tampon	ταμπόν
Tangens	εφαπτομένη
Tango	τανγκό
Tanklaster	βυτιοφόρο
Tankstelle	βενζινάδικο
Tanne	έλατο
Tannenbaum	έλατο
Tansania	Τανζανία
Tantal	ταντάλιο
Tante	θεία
Tanz	χορός
Tanzen	χορός
Tanzfläche	πίστα
Taormina	Ταορμίνα
Tapete	ταπετσαρία
Tapir	τάπιρος
Tarantel	ταραντούλα
Tarent	Τάραντας
Tarnung	καμουφλάζ
Taro	κολοκασία
Tartelette	μικρή τάρτα
Tasche	τσέπη
Taschenbuch	βιβλίο τσέπης
Taschengeld	χαρτζιλίκι
Taschenlampe	φακός
Taschenmesser	σουγιάς
Taschentuch	μαντήλι
Tasse	φλιτζάνι
Tastatur	πληκτρολόγιο
Taste	πλήκτρο
Tatendrang	ενεργητικότητα
Tatra	Τάτρα
Tatsache	γεγονός
Tau	δροσιά
Tau	παλαμάρι
Taube	περιστέρι
Taufe	βάπτισμα
Taurus	Ταύρος
Tausch	ανταλλαγή
Tauschhandel	αντιπραγματισμός
Tautologie	ταυτολογία
Taxameter	ταξίμετρο
Taxi	ταξί
Taxifahrer	ταξιτζής
Taxifahrt	διαδρομή
Taxonomie	ταξινομία
Technetium	τεχνήτιο
Technik	τεχνική
Teddybär	αρκουδάκι
Tee	τσάι
Teebeutel	φακελάκι
Teekanne	τσαγιέρα
Teelöffel	κουταλάκι
Teer	πίσσα
Teheran	Τεχεράνη
Teich	λιμνούλα
Teig	ζύμη
Teil	μέρος
Teil	κομμάτι
Teilchen	σωμάτιο
Teilchenbeschleuniger	επιταχυντής
Teilnahme	συμμετοχή
Tektonik	τεκτονική
Tel Aviv	Τελ Αβίβ
Telefon	τηλέφωνο
Telefonie	τηλεφωνία
Telefonnummer	τηλέφωνο
Telegramm	τηλεγράφημα
Telekommunikation	τηλεπικοινωνία
Telepathie	τηλεπάθεια
Teleportation	τηλεμεταφορά
Teleskop	τηλεσκόπιο
Tellur	τελλούριο
Tempel	ναός
Temperatur	θερμοκρασία
Tendenz	τάση
Teneriffa	Τενερίφη
Tenness	τενέσιο
Tennessee	Τενεσί
Tennessee	Τενεσί
Tennis	αντισφαίριση
Tentakel	πλοκάμι
Teppich	χαλί
Terbium	τέρβιο
Termin	προθεσμία
Terminologie	ορολογία
Terminverschiebung	αναβολή
Termite	τερμίτες
Terrasse	βεράντα
Territorium	έδαφος
Terror	τρόμος
Terroranschlag	τρομοκρατική επίθεση
Terrorismus	τρομοκρατία
Terrorist	τρομακράτης
Test	δοκιμή
Testament	διαθήκη
Teufel	διάβολος
Texas	Τέξας
Text	κείμενο
Textilfabrik	υφαντουργείο
Thaddäus	Θαδδαίος
Thailand	Ταϊλάνδη
Thallium	θάλλιο
Theater	θέατρο
Theismus	θεϊσμός
Thema	θέμα
Themse	Τάμεσης
Theokratie	θεοκρατία
Theologe	θεολόγος
Theologie	θεολογία
Theophanie	θεοφάνεια
Theorem	θεώρημα
Theoretiker	θεωρητικός
Theorie	θεωρία
Therapeut	θεραπευτής
Therapie	θεραπεία
Thermometer	θερμόμετρο
Thermosflasche	κανάτα θερμός
Thessaloniki	Θεσσαλονίκη
Thomas	Θωμάς
Thorax	θώρακας
Thorium	θόριο
Thriller	θρίλερ
Thrombose	θρόμβωση
Thron	θρόνος
Thulium	θούλιο
Thunfisch	τόνος
Thymian	θυμάρι
Thüringen	Θουριγγία
Tiara	τιάρα
Tiefe	βάθος
Tier	ζώο
Tierarzt	κτηνίατρος
Tierkreis	ζωδιακός κύκλος
Tierpark	ζωολογικός κήπος
Tierquälerei	σκληρότητα των ζώων
Tierreich	ζωικό βασίλειο
Tiflis	Τιφλίδα
Tiger	τίγρη
Tigerin	τίγρη
Tigris	Τίγρις
Tilde	περισπωμένη
Timor	Τιμόρ
Timotheus	Τιμόθεος
Tinktur	βάμμα
Tinte	μελάνι
Tintenfass	μελανοδοχείο
Tirana	Τίρανα
Tirol	Τιρόλο
Tisch	τραπέζι
Tischdecke	τραπεζομάντιλο
Tischkante	άκρη
Tischler	ξυλουργός
Tischnachbar	διπλανός
Tischtennis	επιτραπέζια αντισφαίριση
Titan	τιτάνιο
Titan	τιτάνιο
Titel	τίτλος
Titus	Τίτος
Toaster	φρυγανιέρα
Tochter	κόρη
Tochtermann	γαμπρός
Todeskampf	χαροπάλεμα
Todesstrafe	θανατική ποινή
Todsünde	θανάσιμο αμάρτημα
Togo	Τόγκο
Toilette	αποχωρητήριο
Toilettenpapier	χαρτί υγείας
Tokio	Τόκιο
Tollwut	λύσσα
Tomate	ντομάτα
Ton	άργιλος
Tonga	Τόνγκα
Tongefäß	δοχείο
Tonleiter	κλίμακα
Topas	τοπάζιο
Topf	χύτρα
Topografie	τοπογραφία
Topologie	τοπολογία
Toponym	τοπωνύμιο
Tor	πύλη
Torf	τύρφη
Tornado	σίφωνας
Toronto	Τορόντο
Torpedo	τορπίλη
Torte	πίτα
Torwart	τερματοφύλακας
Toskana	Τοσκάνη
Totengräber	νεκροθάφτης
Totenkopf	νεκροκεφαλή
Totenschädel	νεκροκεφαλή
Toter	νεκρός
Totes Meer	Νεκρά Θάλασσα
Toulouse	Τουλούζη
Tourismus	τουρισμός
Tourist	τουρίστας
Touristeninformation	τουριστικές πληροφορίες
Touristik	τουριστικός
Toxikum	τοξικό
Tracht	στολή
Tradition	παράδοση
Tragödie	τραγωδία
Trainer	προπονητής
Training	προπόνηση
Traktor	τρακτέρ
Transaktion	δοσοληψία
Transistor	τρανζίστορ
Transkription	μεταγραφή
Transnistrien	Υπερδνειστερία
Transzendenz	υπεροχή
Trassat	αποδέκτης
Trauer	πένθος
Traum	όνειρο
Traumtänzer	ονειροπόλος
Traurigkeit	λύπη
Travestie	διακωμώδηση
Trecker	τρακτέρ
Treffen	συνάντηση
Treibhaus	θερμοκήπιο
Trekkie	τρεκάς
Trennung	χωρισμός
Tresor	θησαυροφυλάκιο
Tretboot	θαλάσσιο ποδήλατο
Tretroller	πατίνι
Triangel	τρίγωνο
Triangulation	τριγωνισμός
Trichter	χοάνη
Trick	κόλπο
Trier	Τριέρη
Trillion	πεντάκις εκατομμύριο
Trilogie	τριλογία
Trinidad und Tobago	Τρινιντάντ και Τομπάγκο
Trinkgeld	φιλοδώρημα
Triphthong	τρίφθογγος
Tripolis	Τρίπολη
Triskaidekaphobie	τρισκαιδεκαφοβία
Trizytopenie	παγκυτταροπενία
Trocknen	ξήρανση
Troglodyt	τρωγλοδύτης
Troia	Τροία
Troja	Τροία
Trommel	τύμπανο
Trompete	τρομπέτα
Tropen	τροπικός
Tropfen	σταγόνα
Troposphäre	τροπόσφαιρα
Trost	παρηγοριά
Trottoir	πεζοδρόμιο
Trotz	πείσμα
Troubadix	Κακοφωνίξ
Trumm	ερείπια
Trunkenbold	πότης
Träne	δάκρυ
Tränen vergießen	δάκρυ
Tränensack	δακρυϊκός ασκός
Träumer	ονειροπόλος
Trüffel	τρούφα
Tschad	Τσαντ
Tschechien	Τσεχία
Tschechin	Τσέχα
Tschechisch	τσεχικά
Tschechische Republik	Τσεχική Δημοκρατία
Tschechoslowakei	Τσεχοσλοβακία
Tscheljabinsk	Τσελιάμπινσκ
Tschetschenien	Τσετσενία
Tsetsefliege	μύγα τσε-τσε
Tsunami	τσουνάμι
Tuberkulose	φυματίωση
Tugend	αρετή
Tulpe	τουλίπα
Tumor	όγκος
Tundra	τούντρα
Tunesien	Τυνησία
Tunnel	σήραγγα
Turban	τουρμπάνι
Turbine	στρόβιλος
Turkmenistan	Τουρκμενιστάν
Turkologie	τουρκολογία
Turm	πύργος
Turmfalke	βραχοκιρκίνεζο
Turnier	τουρνουά
Turteltaube	τριγόνι
Tuvalu	Τουβαλού
Tympanon	τύμπανο
Typ	τύπος
Tyrannei	τυραννία
Tänzer	χορευτής
Täter	δράστης
Töpfer	αγγειοπλάστης
Tübingen	Τύμπιγκεν
Tür	πόρτα
Türke	Τούρκος
Türkei	Τουρκία
Türkisch	τουρκικά
Türmchen	πυργίσκος
Türmlein	πυργίσκος
U-Bahn	μετρό
U-Bahn-Haltestelle	σταθμός μετρό
U-Bahn-Station	σταθμός μετρό
U-Bahnhof	σταθμός μετρό
UFO	ΑΤΙΑ
UNO	Ο.Η.Ε
USA	ΗΠΑ
UdSSR	ΕΣΣΔ
Uelzen	Ούελτσεν
Ufa	Ουφά
Ufa	Ουφά
Ufer	όχθη
Uganda	Ουγκάντα
Uhr	ρολόι
Uhrmacher	ρολογάς
Uhu	μπούφος
Ukelei	σίρκο
Ukraine	Ουκρανία
Ukrainisch	ουκρανικά
Ukulele	γιουκαλίλι
Ulm	Ουλμ
Ulme	φτελιά
Ultimatum	τελεσίγραφο
Umarmung	αγκάλιασμα
Umbra	ελαιόμαυροσ
Umfang	περιφέρεια
Umfrage	δημοσκόπηση
Umgangssprache	καθομιλουμένη
Umgebung	περίχωρα
Umgänglichkeit	ευπροσηγορία
Umland	περίχωρα
Umluft	ανακυκλωμένος αέρας
Umschlag	φάκελος
Umschreibung	παράφραση
Umschreibung	μεταβίβαση
Umschrift	μεταγραφή
Umsicht	περίσκεψη
Umwelt	περιβάλλον
Umzug	μετακόμιση
Unabhängigkeit	ανεξαρτησία
Unanständigkeit	απρέπεια
Unbildung	αμάθεια
Unbinilium	ουνμπινίλιο
Unding	παράλογο
Unfall	ατύχημα
Ungar	Ούγγρος
Ungarin	Ουγγαρέζα
Ungarisch	Ουγγρικά
Ungarn	Ουγγαρία
Ungeduld	ανυπομονησία
Ungehorsam	ανυπακοή
Ungewissheit	αβεβαιότητα
Unicode	Unicode
Union der Sozialistischen Sowjetrepubliken	Ένωση Σοβιετικών Σοσιαλιστικών Δημοκρατιών
Universität	πανεπιστήμιο
Universum	σύμπαν
Unkraut	ζιζάνια
Unkraut vergeht nicht	ψόφος
Unpässlichkeit	ανημποριά
Unruh	ταλαντευτήρας
Unruhe	ανησυχία
Unruhestifter	ταραξίας
Unschlitt	ξίγκι
Unsterblichkeit	αθανασία
Unterarm	πήχης
Unterbegriff	υπώνυμο
Unterbrechung	διακοπή
Unterernährung	υποσιτισμός
Untergebener	υφιστάμενος
Untergrundbahn	μετρό
Unterhalt	διατροφή
Unterhaltung	διασκέδαση
Unterhose	σώβρακο
Unterkunft	κατάλυμα
Unterlippe	κάτω χείλος
Untermieter	υπενοικιαστής
Unternehmen	επιχείρηση
Unterricht	μάθημα
Unterscheidung	διάκριση
Unterschied	διαφορά
Unterschlupf	καταφύγιο
Unterschrift	υπογραφή
Unterseeboot	υποβρύχιο
Untersuchungshaft	προφυλάκιση
Untertasse	πιατάκι
Untertitel	υπότιτλος
Ununennium	ουνουνέννιο
Unverfrorenheit	αδιαντροπιά
Unverschämtheit	αδιαντροπιά
Unwetter	κακοκαιρία
Unwirtlichkeit	αφιλοξενία
Unwohlsein	αδιαθεσία
Unzucht	ασέλγεια
Unzulänglichkeit	ανεπάρκεια
Upcycling	ανωκύκλωση
Uran	ουράνιο
Uranus	Ουρανός
Urbanisierung	αστικοποίηση
Ureinwohner	ιθαγενής
Urenkel	δισέγγονος
Urenkelin	δισέγγονη
Urenkelkind	δισεγγόνι
Urgroßmutter	προγιαγιά
Urgroßvater	προπάππος
Urin	ούρο
Urknall	μεγάλη έκρηξη
Urlaub	διακοπές
Ursprache	πρωτογλώσσα
Ursula	Ούρσουλα
Uruguay	Ουρουγουάη
Urwald	παρθένος
Usbekistan	Ουζμπεκιστάν
Usurpator	σφετεριστής
Utah	Γιούτα
Utensil	χρειώδη
Utilitarismus	ωφελιμισμός
Utopie	ουτοπία
Utrecht	Ουτρέχτη
Vaduz	Βαντούζ
Vagina	κόλπος
Vagusnerv	πνευμονογαστρικό νεύρο
Vakuum	κενό
Valencia	Βαλένθια
Valentin	Βαλεντίνος
Valentinstag	ημέρα του Αγίου Βαλεντίνου
Valletta	Βαλέτα
Vanadium	βανάδιο
Vancouver	Βανκούβερ
Vandalismus	βανδαλισμός
Vanille	βανίλια
Vanität	ματαιοδοξία
Vanuatu	Βανουάτου
Variable	μεταβλητή
Variante	παραλλαγή
Vase	βάζο
Vaseline	βαζελίνη
Vater	πατέρας
Vaterland	πατρίδα
Vaterunser	Κυριακή προσευχή
Vatikan	Βατικανό
Vatikanstadt	Βατικανό
Vegetarier	χορτοφάγος
Vegetarismus	χορτοφαγία
Veilchen	μενεξές
Vektor	διάνυσμα
Velours	βελουτέ
Velozität	ταχύτητα
Vene	φλέβα
Venedig	Βενετία
Veneter	αρχαίοι Ενετοί
Venezianerin	Βενετσιάνη
Venezuela	Βενεζουέλα
Ventil	βαλβίδα
Ventilation	εξαερισμός
Ventilator	ανεμιστήρας
Venus	Αφροδίτη
Venusmuschel	αχηβάδα
Verachtung	περιφρόνηση
Veranda	βεράντα
Verantwortlichkeit	υπευθυνότητα
Verantwortung	ευθύνη
Verb	ρήμα
Verbaladjektiv	ρηματικό επίθετο
Verband	σύνδεσμος
Verbindung	σύνδεση
Verbitterung	πικρία
Verbot	απαγόρευση
Verbraucher	καταναλωτής
Verbraucherin	καταναλώτρια
Verbrechen	έγκλημα
Verbrechen gegen die Menschlichkeit	έγκλημα κατά της ανθρωπότητας
Verbrecher	εγκληματίας
Verbundenheit	δεσμός
Verbündeter	σύμμαχος
Verdacht	υποψία
Verdauung	πέψη
Verderben	σάπισμα
Verein	σύλλογος
Vereinigte Arabische Emirate	Ηνωμένα Αραβικά Εμιράτα
Vereinigte Staaten	Ηνωμένες Πολιτείες
Vereinigte Staaten von Amerika	Ηνωμένες Πολιτείες της Αμερικής
Vereinigtes Königreich	Ηνωμένο Βασίλειο
Vereinigtes Königreich Großbritannien und Nordirland	Μεγάλη Βρετανία
Vereinigung	ενοποίηση
Vereinte Nationen	Οργανισμός Ηνωμένων Εθνών
Verfassung	σύνταγμα
Verfassungsrecht	συνταγματικός
Verfolgung	καταδίωξη
Vergangenheit	παρελθόν
Vergewaltigung	βιασμός
Vergissmeinnicht	μη με λησμόνει
Vergleich	σύγκριση
Vergänglichkeit	εφήμερο
Verhaftung	σύλληψη
Verhalten	συμπεριφορά
Verhältnis	αναλογία
Verhör	ανάκριση
Verkauf	πώληση
Verkehr	κίνηση
Verkehrsader	αρτηρία
Verkleinerungsform	υποκοριστικό
Verkäufer	πωλητής
Verlag	εκδοτικός
Verlagshaus	εκδοτικός
Verlangen	επιθυμία
Verlassen	εγκατάλειψη
Verlauf	πορεία
Verletzung	τραύμα
Verleumdung	συκοφαντία
Verlobungsring	βέρα
Verlängerung	παράταση
Vermieter	εκμισθωτής
Verminderung	μείωση
Vermutung	εικασία
Vermögen	δύναμη
Verona	Βερόνα
Veronika	Βερενίκη
Verpflichtung	υποχρέωση
Verrat	προδοσία
Verriegelung	μαντάλωμα
Verringerung	μείωση
Verräter	προδότης
Verrücktheit	τρέλα
Vers	στίχος
Versammlung	συνέλευση
Verschmutzung	μόλυνση
Verschwinden	εξαφάνιση
Verschwörung	συνωμοσία
Verschwörungstheorie	θεωρία συνωμοσίας
Versicherung	ασφάλιση
Versicherungspolice	ασφαλιστήριο
Verstaatlichung	κρατικοποίηση
Versteinerung	απολίθωμα
Verstärker	ενισχυτής
Versuch	προσπάθεια
Versuchskaninchen	κουνέλι
Versuchstier	πειραματόζωο
Versuchung	πειρασμός
Verteidigung	άμυνα
Verteidigungsminister	άμυνα
Verteidigungsministerin	άμυνα
Verteidigungsministerium	ΥΠΕΘΑ
Verteidigungsrede	απολογία
Vertrag	συμβόλαιο
Vertrauen	εμπιστοσύνη
Vertreibung	εκδίωξη
Vertreter	αντικαταστάτης
Verunreinigung	λέρωμα
Verwalter	κυβερνήτης
Verwaltung	διαχείριση
Verwaltungsbehörde	διοικητική αρχή
Verwaltungsbezirk	διαμέρισμα
Verwandter	συγγενής
Verwandtschaft	συγγένεια
Verweigerung	άρνηση
Verwirrung	σύγχυση
Verwünschung	κατάρα
Verzeichnis	κατάλογος
Verzweiflung	απελπισία
Veröffentlichung	δημοσίευμα
Vesta	Βέστα
Vesuv	Βεζούβιος
Veteran	απόστρατος
Viadukt	οδογέφυρα
Vibrator	δονητής
Vicomte	υποκόμης
Video	βίντεο
Videoaufnahme	βιντεοεγγραφή
Videokamera	βιντεοκάμερα
Videoüberwachung	επιτήρηση με βίντεο
Viehzucht	κτηνοτροφία
Vier	τέσσερα
Viereck	τετράγωνο
Vierling	τετράδυμα
Viertel	τέταρτο
Viertel	τέταρτο
Vietnam	Βιετνάμ
Vietnamesisch	Βιετναμέζικα
Vikunja	βικούνια
Villa	βίλα
Vindikation	διεκδίκηση
Violine	βιολί
Violoncello	βιολοντσέλο
Virus	ιός
Visum	βίζα
Vitalität	ζωντάνια
Vizepräsident	αντιπρόεδρος
Vogel	πουλί
Vogelgrippe	γρίπη των πτηνών
Vogelscheuche	σκίαχτρο
Vokal	φωνήεν
Vokativ	κλητική
Volk	έθνος
Volksabstimmung	δημοψήφισμα
Volksbefragung	δημοψήφισμα
Volksetymologie	παρετυμολογία
Volksrepublik China	Λαϊκή Δημοκρατία της Κίνας
Volksrepublik Donezk	Λαϊκή Δημοκρατία του Ντονέτσκ
Volksrepublik Lugansk	Λαϊκή Δημοκρατία του Λουγκάνσκ
Volksstamm	φυλή
Volleyball	πετοσφαίριση
Vollmacht	πληρεξούσιο
Vollmond	πανσέληνος
Vollständigkeit	πληρότητα
Volt	βολτ
Volumenstrom	παροχή όγκου
Vorabend	παραμονή
Voraussetzung	προϋπόθεση
Vorbedingung	προϋπόθεση
Vorfahr	πρόγονος
Vorgabe	νόρμα
Vorgesetzter	προϊστάμενος
Vorhandensein	ύπαρξη
Vorhang	αυλαία
Vorhof	προαύλιο
Vorhängeschloss	λουκέτο
Vormacht	ηγεμονία
Vormittag	πρωί
Vorname	όνομα
Vorrichtung	μηχανισμός
Vorschlag	πρόταση
Vorschlaghammer	βαριά
Vorsehung	πρόνοια
Vorsicht	προσοχή
Vorsitzender	πρόεδρος
Vorspeise	ορεκτικό
Vorsprung	προβάδισμα
Vorstadt	προάστιο
Vorteil	πλεονέκτημα
Vorurteil	προκατάληψη
Vulkan	ηφαίστειο
Vulkanausbruch	έκρηξη
Vulkanologie	ηφαιστειολογία
Vulva	αιδοίο
Vuvuzela	βουβουζέλα
Völkermord	γενοκτονία
Völkerrecht	δίκαιο
WC	WC
WC-Papier	χαρτί υγείας
Waage	ζυγαριά
Wacholder	γιουνίπερος
Wacholderdrossel	κεδρότσιχλα
Wachs	κερί
Wachsmalkreide	κηρομπογιά
Wachstum	ανάπτυξη
Wachtel	ορτύκι
Wachtelkönig	ορτυκομάνα
Wade	γάμπα
Waffe	όπλο
Waffel	γκοφρέτα
Waffenstillstand	ανακωχή
Wagen	αμάξι
Wagenrad	ρόδα
Wahl	εκλογή
Wahlberechtigte	ψηφοφόρος
Wahlberechtigter	ψηφοφόρος
Wahlbeteiligung	συμμετοχή
Wahlbetrug	καλπονοθεία
Wahlergebnis	αποτέλεσμα
Wahlkampf	προεκλογικός
Wahlsieg	εκλογικός
Wahlurne	κάλπη
Wahn	παραίσθηση
Wahrheit	αλήθεια
Waise	ορφανός
Wal	φάλαινα
Walachei	Βλαχία
Wald	δάσος
Waldbrand	πυρκαγιά δασών
Waldkauz	χουχουριστιής
Wales	Ουαλία
Walisisch	Ουαλικά
Walküre	βαλκυρία
Wallis	Βαλαί
Wallonisch	βαλλωνικά
Walnuss	καρύδι
Walnussbaum	καρυδιά
Walross	θαλάσσιος ίππος
Walze	οδοστρωτήρας
Wand	τοίχωμα
Wanderer	οδοιπόρος
Wanderfalke	πετρίτης
Wanderung	πεζοπορία
Wange	μάγουλο
Wanze	κοριός
Wappen	εθνόσημο
Ware	εμπόρευμα
Warschau	Βαρσοβία
Wartung	συντήρηση
Warze	κρεατοελιά
Was ist das	Τι είναι
Waschbrett	σκαφίδι πλυσίματος
Waschbär	ρακούν
Waschmaschine	πλυντήριο
Washington	Ουάσινγκτον
Wasserbombe	νερόμπομπα
Wasserfall	καταρράκτης
Wasserfloh	δάφνια
Wasserflugzeug	υδροπλάνο
Wasserhahn	βρύση
Wasserkraft	υδραυλικός
Wasserkraftwerk	εργοστάσιο
Wassermann	Υδροχόος
Wassermelone	καρπούζι
Wassern	προσθαλάσσωση
Wasserpfütze	λακκούβα
Wasserreservoir	στέρνα
Wasserscheide	υδροκρίτης
Wasserstoff	υδρογόνο
Wasserstoffbrückenbindung	δεσμός
Wassersucht	υδρωπικία
Wasserturbine	υδροστρόβιλος
Wasservogel	υδρόβια πουλιά
Wasserzeichen	υδατογράφημα
Wasserzähler	υδρόμετρο
Watt	βατ
Watte	βαμβάκι
Weber	υφαντής
Weblog	ιστολόγιο
Webseite	ιστοσελίδα
Website	ιστότοπος
Wechsel	αλλαγή
Wechselstrom	εναλλασσόμενο ρεύμα
Wechselstube	ανταλλακτήριο συναλλάγματος
Wecken	εγερτήριο
Wecker	ξυπνητήρι
Weg	δρόμος
Weggabel	διακλάδωση
Weggabelung	διακλάδωση
Wehe	πόνος
Wehrmacht	Βέρμαχτ
Wehrpflichtiger	στρατεύσιμος
Weibchen	θηλυκό
Weichsel	Βιστούλας
Weichteile	μαλακά μόρια
Weichtier	μαλάκιο
Weide	ιτιά
Weihnachten	Χριστούγεννα
Weihnachtsbaum	δένδρο
Weihnachtsgeschenk	χριστουγεννιάτικο δώρο
Weihnachtsinsel	Νήσος των Χριστουγέννων
Weihnachtslied	κάλαντα
Weihnachtsmann	Άγιος Βασίλης
Weihnachtsmarkt	χριστουγεννιάτικος
Weihrauch	θυμίαμα
Weimar	Βαϊμάρη
Weimarer Republik	Δημοκρατία της Βαϊμάρης
Wein	αμπέλι
Weinberg	αμπέλι
Weinflasche	μπουκάλι του κρασιού
Weintraube	σταφύλια
Weisheit	σοφία
Weisheitszahn	φρονιμίτης
Weizen	σιτάρι
Weizenmehl	σιτάλευρο
Weiß	λευκό
Weißkohl	λάχανο
Weißrusse	Λευκορώσος
Weißrussin	Λευκορωσίδα
Weißrussisch	Λευκορωσικά
Weißrussland	Λευκορωσία
Weißwein	λευκό κρασί
Welle	κύμα
Wellenlänge	μήκος κύματος
Wellington	Ουέλλινγκτον
Welpe	κουτάβι
Wels	γουλιανός
Welt	κόσμος
Weltall	σύμπαν
Weltanschauung	κοσμοθεωρία
Weltbevölkerung	πληθυσμός
Weltbild	κοσμοθεωρία
Weltgesundheitsorganisation	Παγκόσμια Οργάνωση Υγείας
Weltkarte	παγκόσμιος
Weltkrieg	πόλεμος
Weltmeister	πρωταθλητής
Weltmeisterschaft	πρωτάθλημα
Weltuntergang	συντέλεια του κόσμου
Wendekreis	τροπικός
Wendeltreppe	γυριστή σκάλα
Werbung	διαφήμιση
Werfall	ονομαστική
Werft	ναυπηγείο
Werk	έργο
Werkstatt	εργαστήριο
Werkzeug	εργαλείο
Wermut	αψινθιά
Wert	αξία
Wertpapier	αξιόγραφο
Werwolf	λυκάνθρωπος
Weser	Βέζερ
Wesfall	γενική
Wespe	σφήκα
Wessen-Fall	γενική
West Virginia	Δυτική Βιρτζίνια
Westdeutschland	Δυτική Γερμανία
Westen	δύση
Western	γουέστερν
Westeuropa	Δυτική Ευρώπη
Westfälischer Friede	συνθήκη
Westgote	Βησιγότθος
Westjordanland	Δυτική Όχθη
Westküste	δυτική ακτή
Westsahara	Δυτική Σαχάρα
Wettbewerb	διαγωνισμός
Wette	στοίχημα
Wetter	καιρός
Wetterfahne	ανεμοδείκτης
Wetzlar	Βέτσλαρ
Whisky	ουίσκι
Whist	ουίστ
Wickeltisch	αλλαξιέρα
Widder	Κριός
Widerrede	αντίρρηση
Widerspruch	αντίφαση
Widerstand	αντίσταση
Wiedehopf	τσαλαπετεινός
Wiederbelebung	αναγέννηση
Wiedergabe	απόδοση
Wiedergeburt	αναγέννηση
Wiederholung	επανάληψη
Wiederkäuer	μηρυκαστικό
Wiederwahl	επανεκλογή
Wiege	κούνια
Wien	Βιέννη
Wiesbaden	Βίζμπαντεν
Wiese	λιβάδι
Wiesel	νυφίτσα
Wikiwörterbuch	Βικιλεξικό
Wiktionary	Βικιλεξικό
Wildblume	αγριολούλουδο
Wilderei	λαθροθηρία
Wildgans	αγριόχηνα
Wildkatze	αγριόγατα
Wildpflanze	άγριος
Wildschwein	αγριογούρουνο
Wilhelm	Γουλιέλμος
Wilhelmshaven	Βιλχελμσχάφεν
Wille	θέληση
Willenserklärung	δήλωση βούλησης
Wimper	βλεφαρίδα
Wimperntusche	μάσκαρα
Wind	άνεμος
Windel	πάνα
Windkraft	αιολικός
Windkraftanlage	ανεμογεννήτρια
Windmühle	ανεμόμυλος
Windpocke	ανεμοβλογιά
Winkel	γωνία
Winter	χειμώνας
Wintersonnenwende	χειμερινό ηλιοστάσιο
Wintersport	χειμερινό άθλημα
Winzer	αμπελουργός
Wirbelsturm	κυκλώνας
Wirbelsäule	σπονδυλική στήλη
Wirbeltier	σπονδυλωτό
Wirklichkeit	πραγματικότητα
Wirt	ξενιστής
Wirtschaft	οικονομικά
Wirtschaftswachstum	οικονομική ανάπτυξη
Wisconsin	Ουισκόνσιν
Wismar	Βίσμαρ
Wismut	βισμούθιο
Wissen	γνώση
Wissenschaft	επιστήμη
Wissenschaftler	επιστήμονας
Wissenschaftlerin	επιστήμονας
Witwe	χήρα
Witwer	χήρος
Witz	ανέκδοτο
Wladiwostok	Βλαδιβοστόκ
Woche	εβδομάδα
Wochenende	σαββατοκύριακο
Wochentag	μέρα
Wochenzeitschrift	περιοδικό
Wodka	βότκα
Wohlstand	ευημερία
Wohnblock	οικοδομικό τετράγωνο
Wohnen	κατοίκηση
Wohnort	διαμονή
Wohnsiedlung	συνοικία
Wohnung	διαμέρισμα
Wohnzimmer	σαλόνι
Wolf	Βολφ
Wolf	λύκος
Wolfram	βολφράμιο
Wolframit	βολφραμίτης
Wolfsbarsch	λαβράκι
Wolfsburg	Βόλφσμπουργκ
Wolga	Βόλγας
Wolga	Βόλγας
Wolga	Βόλγας
Wolke	σύννεφο
Wolkenkratzer	ουρανοξύστης
Wolle	μαλλί
Workaholic	εργασιομανής
World Trade Center	Παγκόσμιο Κέντρο Εμπορίου
Wort	λέξη
Wortart	μέρος του λόγου
Wortbildung	σχηματισμός
Wortschatz	λεξιλόγιο
Worttrennung	συλλαβισμός
Wotan	Βόταν
Wrack	ναυάγιο
Wucher	τοκογλυφία
Wunder	θαύμα
Wunderkerze	βεγγαλικό
Wunsch	ευχή
Wupper	Βούπερ
Wuppertal	Βούπερταλ
Wurm	σκουλήκι
Wurst	λουκάνικο
Wurzel	ρίζα
Wut	οργή
Wyoming	Ουαϊόμινγκ
Wächter	φύλακας
Wähler	εκλογέας
Wählerschaft	εκλογικό σώμα
Währung	νόμισμα
Wärme	ζέστη
Wäschetrockner	στεγνωτήριο
Wölfin	λύκαινα
Wörterbuch	λεξικό
Würde	αξιοπρέπεια
Würdenträger	αξιωματούχος
Würfel	κύβος
Wüste	έρημος
Xanthelasma	ξανθέλασμα
Xanthi	Ξάνθη
Xanthophyll	ξανθοφύλλη
Xanthopsie	ξανθοψία
Xenon	ξένο
Xenotransplantation	ξενομεταμόσχευση
Xerophthalmie	ξηροφθαλμία
Xi	ξι
Xylophon	ξυλόφωνο
Yacht	θαλαμηγός
Yggdrasil	Υγκντράσιλ
Yoga	γιόγκα
Ypern	Υπρ
Ypsilon	ύψιλον
Ytterbium	υττέρβιο
Yttrium	ύττριο
Zacharias	Ζαχαρίας
Zahl	αριθμός
Zahn	δόντι
Zahnarzt	οδοντίατρος
Zahnbürste	οδοντόβουρτσα
Zahnfleisch	ούλα
Zahnpasta	οδοντόκρεμα
Zahnrad	γρανάζι
Zahnseide	οδοντικό νήμα
Zahnstocher	οδοντογλυφίδα
Zander	ποτάμια πέρκη
Zapfen	κουκουνάρι
Zapfsäule	αντλία βενζίνης
Zar	τσάρος
Zauberei	μαγεία
Zauberer	μάγος
Zauberspruch	μαγικός
Zaun	φράχτης
Zaziki	τζατζίκι
Zeder	κέδρος
Zehe	δάχτυλο ποδιού
Zehn	δέκα#Substantiv, n, indeklinabel
Zeichenbrett	σχεδιαστήριο
Zeichentrickfilm	κινούμενα σχέδια
Zeichner	σχεδιαστής
Zeigefinger	δείκτης
Zeit	χρόνος
Zeit ist Geld	ο χρόνος είναι χρήμα
Zeitbombe	ωρολογιακή βόμβα
Zeitform	χρόνος
Zeitgenosse	σύγχρονος
Zeitschrift	περιοδικό
Zeitung	εφημερίδα
Zeitwort	ρήμα
Zelle	κύτταρο
Zellkern	πυρήνας
Zellulose	κυτταρίνη
Zellwand	κυτταρικό τοίχωμα
Zelt	σκηνή
Zelten	κατασκήνωση
Zeltplatz	κατασκήνωση
Zement	τσιμέντο
Zen	Ζεν
Zenit	ζενίθ
Zensur	λογοκρισία
Zentimeter	εκατοστόμετρο
Zentralafrikanische Republik	Κεντροαφρικανική Δημοκρατία
Zentralverriegelung	κλείδωμα
Zentrifuge	φυγοκεντρική μηχανή
Zentrum	κέντρο
Zenturie	εκατονταρχία
Zepter	σκήπτρο
Zermatt	Τσερμάτ
Zerstreuung	διασκέδαση
Zerstörer	αντιτορπιλικό
Zeug	πράγματα
Zeuge	μάρτυρας
Zeugnis	μαρτυρία
Zeus	Δίας
Ziege	κατσίκα
Ziegelstein	τούβλο
Ziegenkäse	κατσικίσιο τυρί
Ziegenmilch	κατσικίσιο γάλα
Ziel	στόχος
Zierpflanze	καλλωπιστικός
Ziffer	ψηφίο
Zigarette	τσιγάρο
Zigarettenstummel	αποτσίγαρο
Zigarre	πούρο
Zigeuner	τσιγγάνος
Zikade	τζιτζίκι
Zimmer	δωμάτιο
Zimmerer	μαραγκός
Zimmermann	μαραγκός
Zimmermädchen	καμαριέρα
Zimmerschlüssel	κλειδί
Zimmertemperatur	θερμοκρασία
Zimt	κανέλα
Zimt	κανελί
Zink	ψευδάργυρος
Zinn	κασσίτερος
Zionismus	Σιωνισμός
Zirkel	διαβήτης
Zirkonium	ζιρκόνιο
Zirkumflex	περισπωμένη
Zirkus	τσίρκο
Zirrhose	κίρρωση
Zisterne	στέρνα
Zither	τσίτερ
Zitrone	λεμόνι
Zitronenschale	λεμονόφλουδα
Zitronensäure	κιτρικό οξύ
Zivilbevölkerung	άμαχος πληθυσμός
Zivilisation	πολιτισμός
Zivilist	πολίτης
Zivilstandsamt	ληξιαρχείο
Zobel	ζιμπελίνα
Zoll	ίντσα
Zoll	δασμός
Zombie	ζόμπι
Zone	ζώνη
Zoologie	ζωολογία
Zorn	θυμός
Zucchini	κολοκυθάκι
Zucker	ζάχαρη
Zuckerbäcker	ζαχαροπλάστης
Zuckerdose	ζαχαριέρα
Zuckerrohr	ζαχαροκάλαμο
Zuckerrübe	ζαχαρότευτλο
Zuckerwatte	μαλλί της γριάς
Zufall	σύμπτωση
Zufluchtsort	καταφύγιο
Zug	τρένο
Zugang	πρόσβαση
Zugbegleiter	ελεγκτής
Zuhörer	ακροατής
Zukunft	μέλλον
Zuluft	παρεχόμενος αέρας
Zunahme	αύξηση
Zuneigung	στοργή
Zunge	γλώσσα
Zungenbrecher	γλωσσοδέτης
Zungenspatel	γλωσσοπίεστρο
Zurschaustellen	επίδειξη
Zurschaustellung	επίδειξη
Zusammenarbeit	συνεργασία
Zusammenhang	συνοχή
Zusammensetzung	σύνθεση
Zuschauer	θεατής
Zustand	κατάσταση
Zustimmung	επιδοκιμασία
Zuversicht	αισιοδοξία
Zuwachs	αύξηση
Zuwendung	στοργή
Zuwenig	έλλειψη
Zwangsarbeit	καταναγκαστική εργασία
Zwangsjacke	ζουρλομανδύας
Zweck	σκοπός
Zweifel	αμφιβολία
Zweig	κλαδἁκι
Zweistromland	Μεσοποταμία
Zweiter Weltkrieg	Β' Παγκόσμιος Πόλεμος
Zweizimmerwohnung	δυάρι
Zwerchfell	διάφραγμα
Zwerg	νάνος
Zwergohreule	γκιόνης
Zwieback	παξιμάδι
Zwiebel	κρεμμύδι
Zwilling	δίδυμος
Zwischenkriegszeit	μεσοπόλεμος
Zwölffingerdarm	δωδεκαδάκτυλο
Zwölftel	δωδέκατο
Zyanid	κυανίδιο
Zygote	ζυγωτό
Zyklon	κυκλώνας
Zyklop	Κύκλωπας
Zylinder	κύλινδρος
Zyniker	κυνικός
Zynikerin	κυνική
Zynismus	κυνισμός
Zypern	Κύπρος
Zyprer	Κύπριος
Zyprerin	Κύπρια
Zypresse	κυπαρίσσι
Zypriot	Κύπριος
Zypriotin	Κύπρια
Zyste	κύστη
Zytologie	κυτταρολογία
Zytoplasma	κυτταρόπλασμα
Zytoskelett	κυτταρικός σκελετός
Zytostatikum	κυτταροστατική
Zähler	μετρητής
Zäsur	τομή
Zölibat	αγαμία
Zügel	ηνίο
Zündtemperatur	σημείο αυτανάφλεξης
Zürich	Ζυρίχη
a	α
a priori	α πριόρι
a-	α-
aalglatt	γλιστερός
ab	από
ab und zu	κάπου κάπου
abbaubar	αποικοδομήσιμος
abbezahlen	εξοφλώ
abbrechen	σπάζω
abbreviieren	συντομέυω
abdecken	αποκαλύπτω
abendlich	βραδινός
abends	βράδυ
aber	αλλά
abergläubisch	προληπτικός
abfahren	αναχωρώ
abfliegen	αναχωρώ
abgelegen	απόκεντρος
abgemacht	έγινε
abhauen	χάνομαι
abkürzen	κόβω
ablehnen	απορρίπτω
abnutzen	φθείρω
absagen	ακυρώνω
abschaffen	καταργώ
abschalten	σβήνω
abschmecken	δοκιμάζω
abschüssig	απόκρημνος
abseits	παράμερα
abseits	μακριά
absolut	απόλυτος
absoluter Nullpunkt	απόλυτο μηδέν
absolvieren	αποφοιτώ
absorbieren	απορροφώ
abstimmen	ψηφίζω
abstrakt	αφηρημένος
abstreiten	αρνούμαι
absurd	παράλογος
absurdes Theater	θέατρο του παραλόγου
abtippen	δακτυλογραφώ
abwesend	απών
abändern	αλλάζω
ach	α
achromatisch	αχρωματικός
acht	οκτώ
achte	όγδοος
achtel	όγδοο
achthundert	οκτακόσια
achtundachtzig	ογδόντα οκτώ
achtunddreißig	τριάντα οκτώ
achtundzwanzig	είκοσι οκτώ
achtzehn	δεκαοκτώ
achtzehnte	δέκατος όγδοος
achtzig	ογδόντα
achtzigste	ογδοηκοστός
addieren	προσθέτω
adiabatisch	αδιαβατικός
adoptieren	υιοθετώ
adverbial	επιρρηματικός
aero-	αερο-
aerob	αερόβιος
aerodynamisch	αεροδυναμικός
affektiert	επιτηδευμένος
afghanisch	αφγανικός
afrikanisch	αφρικανικός
agglutinierende Sprache	συγκολλητικός
aidskrank	ασθενής του έιτζ
airbrushen	βάφω με πιστολάκι
akademisch	ακαδημαϊκός
akkadisch	ακκαδικός
aktiv	ενεργός
aktuell	επίκαιρος
akustisch	ακουστικός
akzelerieren	επιταχύνω
akzeptieren	δέχομαι
akzessorisch	παρεπόμενος
alarmierend	ανησυχητικός
albanisch	αλβανικός
algebraisch	αλγεβρικός
algerisch	αλγερινός
alkoholfrei	αλκοολούχος
alkoholhaltig	αλκοολούχος
all	όλος
alle Wege führen nach Rom	όλοι οι δρόμοι οδηγούν στη Ρώμη
allein	μόνος
alleinstehend	εργένης
allerseits	όλοι μαζί
alles Gute zum Geburtstag	χαρούμενα γενέθλια
allgemein	γενικός
allmächtig	παντοδύναμος
alltäglich	καθημερινός
alphabetisch	αλφαβητικός
als	από
also	άρα
also	λοιπόν
alt	παλιός
alternativ	εναλλακτικός
altgriechisch	αρχαιοελληνικός
altpreußisch	πρωσικός
altslawisch	αρχαία σλαβική
altweiß	υπόλευκος
alveolar	φατνιακός
amen	αμήν
amerikanisch	αμερικανικός
amerikanischer Traum	όνειρο
amorph	άμορφος
amourös	ερωτικός
amputieren	ακρωτηριάζω
amtlich	επίσημος
an	αναμμένος
an	σε
an Bord	εν πλω
an-	αν-
anachronistisch	παρωχημένος
anal	πρωκτικός
analog	ανάλογος
analysieren	αναλύω
anarchistisch	αναρχικός
anbellen	γαβγίζω
anderer	άλλος
andernfalls	αλλιώς
anderswo	αλλού
androzentrisch	ανδροκεντρικός
anfangen	αρχίζω
anfangs	αρχή
anflehen	ικετεύω
angeblich	δήθεν
angeboren	έμφυτος
angehören	ανήκω
angenehm	ευχάριστος
angenehm	χαίρω
angreifen	επιτίθεμαι
ankommen	φτάνω
annullieren	ακυρώνω
anonym	ανώνυμος
anorganisch	ανόργανος
anpassen	προσαρμόζω
anrufen	καλώ
anschaffen	αγοράζω
anschließen	ακολουθώ
anschwellen	διογκώνομαι
anspannen	ζεύω
anstrengen	προσπαθώ
anstrengend	κουραστικός
anthropo-	ανθρωπο-
antidemokratisch	αντιδημοκρατικός
antifaschistisch	αντιφασίστας
antiklerikal	αντικληρικός
antreffen	βρίσκω
antworten	απαντώ
anziehen	φοράω
anzweifeln	αμφιβάλλω
apokryph	απόκρυφος
apoplektisch	αποπληκτικός
appetitlich	ορεκτικός
applaudieren	χειροκροτώ
arabisch	αραβικός
arbeiten	δουλεύω
arbeitslos	άνεργος
architektonisch	αρχιτεκτονικός
archivieren	αρχειοθετώ
archäologisch	αρχαιολογικός
argentinisch	αργεντίνικος
arid	ξηρός
aristotelisch	αριστοτελικός
arktisch	αρκτικός
arm	φτωχός
armenisch	αρμενικός
arrogant	αλαζονικός
aserbaidschanisch	αζέρικος
asiatisch	ασιατικός
asozial	αντικοινωνικός
asphaltieren	ασφαλτοστρώνω
assoziativ	προσεταιριστικός
assyrisch	ασσυριακός
astronomisch	αστρονομικός
asymmetrisch	ασύμμετρος
athenisch	αθηναϊκός
atmen	αναπνέω
attisch	αττικός
attraktiv	ελκυστικός
auch	επίσης
auf	ανοιχτός
auf	σε
auf Draht sein	είμαι διορατικός
auf Holz klopfen	Χτύπα ξύλο
auf Wiedersehen	εις το επανιδείν
auf des Messers Schneide stehen	είναι στην κόψη του ξυραφιού
auf jeden Fall	οπωσδήποτε
auf keinen Fall	περίπτωση
auf sein	ξύπνιος
auf und nieder	πάνω κάτω
auferstehen	ανασταίνομαι
aufgeweckt	έξυπνος
aufheben	σηκώνω
aufhängen	κρεμώ
aufhören	σταματώ
aufmachen	ανοίγω
aufmerksam	προσεκτικός
aufmüpfig	άτακτος
aufpassen	προσέχω
aufrichten	ανορθώνω
aufrichtig	ειλικρινής
aufräumen	τακτοποιώ
aufstehen	σηκώνομαι
aufwecken	ξυπνώ
aufziehen	ανατρέφω
aus	κλειστό
aus	από
aus allen Wolken fallen	πέφτω απ' τα σύννεφα
aus den Augen, aus dem Sinn	μάτι
aus einer Mücke einen Elefanten machen	κάνω την τρίχα τριχιά
ausbrechen	δραπετεύω
ausbreiten	απλώνω
ausdruckslos	ανέκφραστος
ausfüllen	συμπληρώνω
aushalten	αντέχω
auskurieren	αποθεραπεύω
ausloten	βολιδοσκοπώ
ausländisch	ξένος
ausnutzen	εκμεταλλεύομαι
ausrauben	ληστεύω
ausrenken	εξαρθρώνω
ausruhen	ξεκουράζομαι
ausschmücken	διακοσμώ
aussehen	φαίνομαι
aussetzen	εκθέτω
aussortieren	ξεσκαρτάρω
ausspannen	ξεζεύω
ausspionieren	κατασκοπεύω
ausstehend	ανεξόφλητος
aussteigen	κατεβαίνω
ausstellen	εκθέτω
aussäen	σπέρνω
austauschen	ανταλλάσσω
australisch	αυστραλιανός
auswandern	μεταναστεύω
auswendig	απέξω
ausziehen	ξεντύνω
autark	αυτάρκης
autistisch	αυτιστικός
autochthon	αυτόχθων
autokephal	αυτοκέφαλος
automatisch	αυτόματος
autonom	αυτόνομος
außenpolitisch	εξωτερικής πολιτικής
außer	εκτός
außer Betrieb	λειτουργία
außerdem	εκτός
außerhalb	εκτός
außerhalb	εκτός
axial	αξονικός
b	β
backen	ψήνω
baden	μπάνιο
bakteriell	βακτηριακός
bald	λίγο
baltisch	βαλτικός
bandagieren	επιδένω
bankrottgehen	πτωχεύω
bar	σε μετρητά
barfuß	ξυπόλυτος
barmherzig	εύσπλαχνος
bauen	χτίζω
baufällig	ετοιμόρροπος
baulich	οικοδομικός
baumlos	άδενδρος
baumwollen	βαμβακερός
bayerisch	βαυαρικός
beargwöhnen	υποβλέπω
bebildern	εικονογραφώ
bedauern	λυπάμαι
bedecken	καλύπτω
bedeuten	σημαίνω
bedeutend	σημαντικός
bedeutungslos	ασήμαντος
beeilen	βιάζομαι
beeinflussen	επηρεάζω
beenden	τελειώνω
befinden	βρίσκομαι
begießen	καταβρέχω
beginnen	αρχίζω
beglaubigen	βεβαιώνω
begleichen	εξοφλώ
begutachten	γνωματεύω
behelfsmäßig	προσωρινός
behindert	ανάπηρος
beibehalten	διατηρώ
beide	αμφότεροι
beige	μπεζ
beispielhaft	παραδειγματικός
beitragen	συμβάλλω
beißen	δαγκώνω
bekannt	γνωστός
bekommen	παίρνω
beladen	φορτώνω
beleibt	εύσαρκος
belgisch	βέλγικος
bellen	γαβγίζω
belohnen	αμείβω
bemehlen	αλευρώνω
bemerken	παρατηρώ
bemerkenswert	αξιοσημείωτος
bemitleiden	λυπάμαι
bemittelt	ευκατάστατος
benachbart	γειτονικός
benehmen	συμπεριφέρομαι
benigne	καλοήθης
benötigen	χρειάζομαι
beobachten	παρατηρώ
bequem	άνετος
berechtigen	εξουσιοδοτώ
berechtigt	δικαιολογημένος
bereit	έτοιμος
bereitstellen	διαθέτω
bereitwillig	πρόθυμος
berufstätig	εργαζόμενος
beruhigen	ηρεμώ
berühmt	διάσημος
bescheren	δωρίζω
beschließen	αποφασίζω
beschneiden	κλαδεύω
beschädigen	βλάπτω
beschäftigen	απασχολώ
besichtigen	επισκέπτομαι
besiedeln	εποικίζω
besitzen	κατέχω
besitzlos	άκληρος
besprengen	καταβρέχω
bespringen	βατεύω
besser	καλύτερος
bestechlich	δωροδοκούμενος
bestehen	περνάω
besteigen	ανεβαίνω
bestellen	παραγγέλνω
besteuern	φορολογώ
bestrafen	τιμωρώ
bestrahlen	φωτίζω
bestreichen	αλείφω
bestreiten	αρνούμαι
besuchen	επισκέπτομαι
beteiligen	συμμετέχω
beten	προσεύχομαι
betragen	ανέρχομαι
betreffen	αφορώ
betrügen	απατώ
betteln	ζητιανεύω
betören	γοητεύω
beunruhigen	ανησυχώ
bevollmächtigen	εξουσιοδοτώ
bevor	πριν
bewachen	φρουρώ
bewahrheiten	επαληθεύομαι
bewegen	κινώ
beweinen	κλαίω
beweisen	αποδεικνύω
bewohnen	κατοικώ
bewohnt	κατοικημένος
bewundern	θαυμάζω
bewusstlos	αναίσθητος
bewähren	αποδείχνω
bezaubern	μαγεύω
bezüglich	σχετικά
biblisch	βιβλικός
biegen	κάμπτώ
billiardste	τετράκις εκατομμυριοστός
billig	φτηνός
billigen	επιδοκιμάζω
billionste	τρισεκατομμυριοστός
binden	δένω
biologisch	βιολογικός
bipolar	διπολικός
bis	μέχρι
bisexuell	αμφιφυλόφιλος
bislang	έως τώρα
bisweilen	ενίοτε
bitte	παρακαλώ
bitten	παρακαλώ
bitter	πικρός
bitterböse	οργισμένος
bittersüß	γλυκόπικρος
blau	μπλε
blauäugig	γαλανομάτης
bleichen	λευκαίνω
bleifrei	αμόλυβδος
bleihaltig	μολυβδούχος
blicken	κοιτάζω
blind	τυφλός
blinder Passagier	λαθρεπιβάτης
blindes Vertrauen	εμπιστοσύνη
blond	ξανθός
bluten	αιμορραγώ
bombardieren	βομβαρδίζω
boshaft	μοχθηρός
botanisch	βοτανικός
brandmarken	στιγματίζω
brasilianisch	βραζιλιάνικος
braten	τηγανίζω
brauchen	χρειάζομαι
brauen	ζυθοποιώ
braun	καφέ
brechen	σπάζω
breit	φαρδύς
brennen	καίγομαι
bringen	φέρνω
britisch	βρετανικός
brummig	γκρινιάρης
bräteln	ψήνω
brüderlich	αδελφικός
brüsten	καυχιέμαι
buddhistisch	βουδιστικός
budgetieren	καταρτίζω τον προϋπολογισμό
bugsieren	πλοηγώ
bulgarisch	βουλγαρικός
bunt	πολύχρωμος
burgenlandkroatisch	κροατική χώρα πόλη
byzantinisch	βυζαντινός
bäuchlings	μπρούμυτα
böse	κακός
bücken	σκύβω
bügeln	σιδερώνω
bürgerlich	αστικός
bürokratisch	γραφειοκρατικός
bürsten	βουρτσίζω
chaotisch	χαοτικός
charismatisch	χαρισματικός
chemisch	χημικός
chemische Verbindung	χημική ένωση
chinesisch	κινέζικος
christlich	χριστιανικός
chronisch	χρόνιος
chronologisch	χρονολογικός
circa	περίπου
d	δ
da	επειδή
da	εκεί
dagegen	εναντίον
daktylisch	δακτυλικός
damit	για να
danach	μετά
danebenbenehmen	ανάρμοστα
danke	ευχαριστώ
danken	ευχαριστώ
das A und O	ωμέγα
das macht nichts	πειράζω
dass	πως
dauernd	διαρκής
davonstehlen	απομακρύνομαι
decken	στρώνω
defektives Verb	ελλειπτικό ρήμα
dehumanisieren	αποκτηνώνω
dehydratisieren	αφυδατώνω
dein Wort in Gottes Ohr	από το στόμα σου και στου Θεού τ΄ αυτί
deinstallieren	απεγκαθιστώ
deklinieren	κλίνω
demnach	επομένως
demokratisch	δημοκρατικός
demokratisieren	εκδημοκρατίζω
demotisch	κοινός
den Gürtel enger schnallen	οικονομία
den Rubikon überschreiten	διαβαίνω τον Ρουβίκωνα
denken	σκέφτομαι
denn	γιατί
denn	εκτός
dennoch	ωστόσο
dental	οδοντικός
der	ο
der Appetit kommt beim Essen	τρώγοντας έρχεται η όρεξη
der Schein trügt	φαινόμενο
der Zug ist abgefahren	πέταξε το πουλί
der Zweck heiligt die Mittel	ο σκοπός αγιάζει τα μέσα
derselbe	ίδιος
derweil	εντωμεταξύ
deshalb	γι'αυτό
deutsch	γερμανικός
diabolisch	διαβολικός
diagnostisch	διαγνωστικός
diagnostizieren	διαγιγνώσκω
diagonal	διαγώνιος
dick	χοντρός
die	η
die Katze im Sack kaufen	γουρούνι
die Radieschen von unten betrachten	βλέπω τα ραδίκια ανάποδα
die Tafel aufheben	σηκώνω
die Würfel sind gefallen	ο κύβος ερρίφθη
dieser	αυτός
diesjährig	φετινός
digital	ψηφιακός
diminutiv	υποκοριστικός
dinieren	δειπνώ
distich	δίστιχος
dividieren	διαιρώ
dogmatisch	δογματικός
doppeldeutig	διφορούμενος
doppelt	διπλός
dort	εκεί
drahtlos	ασύρματος
drehen	γυρίζω
drei	τρία
dreibeinig	τρίποδος
dreiblättrig	τρίφυλλος
dreidimensional	τρισδιάστατος
dreieckig	τριγωνικός
dreifüßig	τρίποδος
dreihundertste	τριακοσιοστός
dreiköpfig	τρικέφαλος
dreiundzwanzig	είκοσι τρείς
dreiundzwanzigste	εικοστός τρίτος
dreizehn	δεκατρία
dreizehnte	δέκατος τρίτος
dreißig	τριάντα
dreißigste	τριακοστός
dreschen	αλωνίζω
dringend	επείγων
dritte	τρίτος
drittklassig	κατηγορίας
drohen	απειλώ
drucken	τυπώνω
drunten	κάτω
dumm	χαζός
dunkel	σκοτεινός
dunkelblau	σκούρο μπλε
dunstig	θολός
durchbeißen	καταφέρνω
durchhalten	αντέχω
durchlässig	διαπερατός
durchmachen	τραβώ
durchschnittlich	μέσος
durstig	διψασμένος
duzen	μιλώ στον ενικό
dys-	δυσ-
dysfunktional	δυσλειτουργικός
dämmern	ξημερώνει
dänisch	δανικός
dörren	ξεραίνω
dünn	αδύνατος
düpieren	δουλεύω
dürfen	μπορώ
dürsten	διψώ
eben	ακριβώς
eben	λείος
eben	μόλις
ebenfalls	επίσης
egal	ίδιος
egozentrisch	εγωκεντρικός
ehebrechen	μοιχεύω
ehren	τιμώ
ehrgeizig	φιλόδοξος
ehrlich	ειλικρινής
eifersüchtig	ζηλιάρης
eigen	ίδιος
eigenartig	ιδιόρρυθμος
eigennützig	ιδιοτελής
eilen	σπεύδω
eilig	βιαστικός
ein	ανοιχτό
ein	ένα
ein Tropfen auf den heißen Stein	μάταιος
ein Unding sein	παράλογο
einbürgern	πολιτογραφώ
eindringen	διεισδύω
eine Schwalbe macht noch keinen Sommer	κούκος
einfach	απλός
einfallen	εισβάλλω
einfallsreich	επινοητικός
einfetten	κρέμα
einfrieren	παγώνω
eingeboren	αυτόχθων
eingreifen	επεμβαίνω
einheitlich	ενιαίος
einhundert	εκατό
einhunderterste	εκατοστός πρώτος
einhundertmal	εκατό φορές
einhundertste	εκατοστός
einig	σύμφωνος
einige	μερικοί
einjährig	μονοετής
einkaufen	αγοράζω
einkreisen	περικυκλώνω
einladen	προσκαλώ
einlullen	αποκοιμίζω
einmal	φορά
einrahmen	πλαισιώνω
einreisen	εισέρχομαι
einrenken	ανατάσσω
eins	ένα
einsacken	βουλιάζω
einsam	μόνος
einschlafen	αποκοιμιέμαι
einschließen	κλειδώνω
einschläfern	κοιμίζω
einschüchtern	εκφοβίζω
einsilbig	μονοσύλλαβος
einstig	άλλοτε
eintausend	χίλιοι
eintägig	μονοήμερος
einunddreißig	τριάντα έν
einundzwanzig	είκοσι ένα
einundzwanzigste	εικοστός πρώτος
einverstanden	σύμφωνος
einzig	μοναδικός
einzigartig	μοναδικός
einzäunen	περιφράζω
einäugig	μονόφθαλμος
eisenhaltig	σιδηρούχος
eisern	σιδερένιος
eisig	παγερός
eitel	ματαιόδοξος
eiweißhaltig	πρωτεϊνούχος
ekklesio-	εκκλησιαστικός
elastisch	ελαστικός
elegant	κομψός
elektrisch	ηλεκτρικός
elektronisch	ηλεκτρονικός
elf	έντεκα
elfte	ενδέκατος
emigrieren	μεταναστεύω
emotional	συναισθηματικός
empfangen	λαμβάνω
empfehlen	συνιστώ
empirisch	εμπειρικός
empor	άνω
empor-	ανα-
endemisch	ενδημικός
enden	τελειώνω
endgültig	οριστικός
endlich	πεπερασμένος
endlich	επιτέλους
endogen	ενδογενής
eng	στενός
englisch	αγγλικός
engstirnig	στενοκέφαλος
entbehrlich	περιττός
entdecken	ανακαλύπτω
enteignen	απαλλοτριώνω
enterben	αποκληρώνω
entfachen	ανάβω
entfernen	αφαιρώ
entführen	απάγω
entgegen	προς
entgegnen	απαντώ
entgleisen	εκτροχιάζομαι
enthüllen	αποκαλύπτω
entlang	μήκος
entlaufen	δραπετεύω
entlegen	απόκεντρος
entnehmen	βγάζω
entschlossen	αποφασισμένος
entspannen	χαλαρώνω
entsprechend	ανάλογος
entsprechend	ανάλογα με
entströmen	διαρρέω
enttäuschen	απογοητεύω
entweder … oder	ή
entziffern	αποκρυπτογραφώ
epidemiologisch	επιδημιολογικός
epidemisch	επιδημικός
episch	επικός
erben	κληρονομώ
erblich	κληρονομικός
erbringen	αποφέρω
erden	γειώνω
ereignen	συμβεί
erektil	στυτικός
erfahren	έμπειρος
erfahren	δοκιμάζω
erfassen	αρπάζω
erforschen	ερευνώ
ergo	επομένως
ergänzen	συμπληρώνω
erhöhen	αυξάνω
erinnern	θυμάμαι
erkundigen	πληροφορούμαι
erlauben	επιτρέπω
erleichtern	διευκολύνω
ermorden	δολοφονώ
ermuntern	ενθαρρύνω
ermutigen	ενθαρρύνω
ermüden	κουράζω
ernähren	τρέφω
erobern	κατακτώ
erotisch	ερωτικός
erpressen	εκβιάζω
erscheinen	εμφανίζομαι
erschießen	τουφεκίζω
erschlaffen	ατονώ
erschüttern	σείω
ersetzen	αντικαθιστώ
erstaunlich	εκπληκτικός
erste	πρώτος
erstens	πρώτον
erstgeboren	πρωτοτόκος
erwachsen	ενήλικος
erwarten	περιμένω
erwerben	αποκτώ
erwähnen	αναφέρω
erwähnenswert	αναφορά
erz-	αρχι-
erziehen	ανατρέφω
erzkonservativ	υπερσυντηρητικός
erzwingen	αποσπώ
erzählen	διηγούμαι
es	αυτό
es ist nicht alles Gold, was glänzt	ό,τι λάμπει δεν είναι χρυσός
es war einmal	μια φορά κι έναν καιρό
essen	τρώω
estnisch	εσθονικός
etablieren	εγκαθιστώ
ethisch	ηθικός
ethnische Säuberung	εθνοκάθαρση
etwas	λίγο
etwas kommt jemandem spanisch vor	αὐτὰ μοῦ φαίνονται κινέζικα
etymologisch	ετυμολογικός
euer	εσάς
europäisch	ευρωπαϊκός
evangelisch	ευαγγελικὀς
ewig	αιώνιος
existieren	υπάρχω
exklusiv	αποκλειστικός
exogen	εξωγενής
exorbitant	εξαιρετικός
exorzieren	εξορκίζω
expedieren	αποστέλλω
experimentieren	πειραματίζομαι
exploitieren	εκμεταλλεύομαι
fachkundig	ειδικός
fahren	οδηγώ
fallen	πέφτω
falsch	λάθος
falscher Freund	ψευδόφιλος
falten	διπλώνω
fantastisch	φανταστικός
farbig	έγχρωμος
farblos	άχρωμος
fast	σχεδόν
fasten	νηστεύω
faul	σάπιος
fehlen	λείπω
fein	ψιλός
feindlich	εχθρικός
fernsehen	τηλεόραση
festlich	εορταστικός
festmachen	στερεώνω
festnehmen	συλλαμβάνω
fettlöslich	λιποδιαλυτός
feuern	ανάβω
ficken	γαμώ
fiebern	πυρετό
finanziell	οικονομικός
finden	βρίσκω
findig	επινοητικός
finnisch	φινλανδικός
fischen	ψαρεύω
flachsen	καλαμπουρίζω
flaggen	σημαιοστολίζομαι
flechten	πλέκω
fleißig	επιμελής
flektieren	κλίνω
flexibel	εύκαμπτος
fliegen	πετώ
fliegende Untertasse	ιπτάμενος δίσκος
fliehen	ξεφεύγω
fließen	ρέω
flirten	φλερτάρω
fluten	πλημμυρίζω
flüssig	υγρός
flüstern	ψιθυρίζω
fokussieren	εστιάζω
folgen	ακολουθώ
folgend	επόμενος
folglich	συνεπώς
foltern	βασανίζω
fortschrittlich	προοδευτικός
fortsetzen	συνεχίζω
fotografieren	φωτογραφίζω
fragen	ρωτώ
fragmentarisch	αποσπασματικός
fragwürdig	αμφίβολος
französisch	γαλλικός
frech	θρασύς
frei	ελεύθερος
freisprechen	αθωώνω
freiwillig	προαιρετικός
fremd	άγνωστος
fremdenfeindlich	ξενόφοβος
freuen	χαίρομαι
freundlich	φιλικός
friedlich	ειρηνικός
frieren	κρυώνω
frikativ	τριβόμενος
frisch	φρέσκος
froh	χαρούμενος
frohe Ostern	Καλό Πάσχα
frohe Weihnachten	καλά Χριστούγεννα
frohes neues Jahr	καλή χρονιά
fromm	ευσεβής
fruchtlos	άκαρπος
früh	νωρίς
früh	νωρίς
früher	νωρίτερα
frühlingshaft	ανοιξιάτικος
frühstücken	προγευματίζω
fummeln	ψηλαφίζω
funktionieren	λειτουργώ
furzen	κλάνω
fähig	ικανός
förmlich	επίσημος
fühlbar	αισθητός
fühlen	αισθάνομαι
füllen	γεμίζω
fünf	πέντε
fünfhundert	πεντακόσιοι
fünfhundertste	πεντακοσιοστός
fünfte	πέμπτος
fünfundzwanzig	είκοσι πέντε
fünfzehn	δεκαπέντε
fünfzehnte	δέκατος πέμπτος
fünfzig	πενήντα
fünfzigste	πεντηκοστός
für	για
fürchten	φοβάμαι
fürsorglich	στοργικός
galaktisch	γαλαξιακός
gallisch	γαλατικός
ganz	ολόκληρος
gasförmig	αεριώδης
gastral	γαστρικόσ
gastrisch	γαστρικόσ
gastrointestinal	γαστρεντερικός
geben	δίνω
geboren	γένος
gebranntes Kind scheut das Feuer	όποιος καεί με το χυλό φυσά και το γιαούρτι
gebrochen	καταρρακωμένος
gebären	γεννώ
gebürtig	καταγόμενος
geduldig	υπομονετικός
geeignet	κατάλληλος
gefahrlos	ακίνδυνος
gefallen	αρέσω
gefrieren	παγώνω
gefährlich	επικίνδυνος
gegen	ενάντια
gegenseitig	αμοιβαίος
gegenwärtig	τωρινός
gegenüber	απέναντι
geheim	μυστικός
geheimnisvoll	μυστικός
gehen	πηγαίνω
gehorchen	υπακούω
gehorsam	υπάκουος
gehässig	ζηλόφθονος
gehören	ανήκω
geistiges Eigentum	διανοητική ιδιοκτησία
gekrümmt	καμπύλος
gelb	κίτρινος
gemütlich	άνετος
genau	ακριβής
generell	γενικός
genug	αρκετός
genügend	αρκετός
genügsam	αυτάρκης
geologisch	γεωλογικός
georgisch	γεωργιανός
geozentrisch	γεωκεντρικός
gepfeffert	αλμυρός
gerade	μόλις
geradeaus	ευθεία
germanisch	γερμανικός
gern	ευχαρίστως
gerne	ευχαρίστως
geräuschlos	αθόρυβος
gesamt	συνολικός
geschehen	συμβαίνω
geschickt	επιδέξιος
geschlossener Vokal	κλειστό φωνήεν
gesetzlich	νομικός
gesichtslos	απρόσωπος
gesprenkelt	διάστικτος
gestern	χθες
gesund	υγιής
gewalttätig	βίαιος
gewinnen	κερδίζω
gewohnt	συνηθισμένος
gewähren	παρέχω
gewöhnlich	συνηθισμένος
gießen	χύνω
glauben	πιστεύω
glaubwürdig	αξιόπιστος
gleichartig	ομοειδής
gleichgültig	αδιάφορος
gleichwertig	ισοδύναμος
gleichzeitig	σύγχρονος
global	παγκόσμιος
gläubig	ευλαβής
glücklich	ευτυχισμένος
glückselig	πανευτυχής
golden	χρυσός
googeln	γκουγκλάρω
gotisch	γοτθικός
gottlos	ασεβής
graben	σκάβω
grafisch	γραφικός
grammatikalisch	γραμματικός
grammatisch	γραμματικός
grammatisches Geschlecht	γραμματικό γένος
grasen	βόσκω
gratulieren	συγχαίρω
grau	γκρίζος
griechisch	ελληνικός
griechischer Salat	χωριάτικη σαλάτα
griechisches Alphabet	ελληνικό αλφάβητο
grillen	ψήνω
grillieren	ψήνω
groß	μεγάλος
große Augen machen	μένω άφωνος
großziehen	ανατρέφω
grundlegend	ριζικός
grönländisch	γροιλανδικός
grün	πράσινος
gründen	ιδρύω
gucken	κοιτάζω
gut	καλός
gute Besserung	περαστικά
gute Nacht	καληνύχτα
guten Abend	καλησπέρα
guten Appetit	καλή όρεξη
guten Morgen	καλημέρα
guten Tag	καλημέρα
gynäkologisch	γυναικολογικός
gähnen	χασμουριέμαι
göttlich	θεϊκός
gültig	έγκυρος
günstig	φτηνός
haben	έχω
habgierig	άπληστος
habilitieren	υφηγητής
hacken	κόβω
hacken	χακάρω
hageln	πέφτει χαλάζι
halb	μισός
halleluja	αλληλούια
hallo	γεια
handschriftlich	χειρόγραφος
haploid	απλοειδής
haptisch	απτός
harmonisch	αρμονικός
hart	σκληρός
hassen	μισήσει
hatschi	αψού
hebräisch	εβραϊκός
heftig	βίαιος
heilen	γιατρεύω
heilig	ιερός
heimlich	κρυφός
heiraten	παντρεύομαι
heiser	βραχνός
heizen	ζεσταίνω
heiß	ζεστός
heißen	λέγομαι
hektisch	νευρικός
heliozentrisch	ηλιοκεντρικός
hell	φωτεινός
hellenisch	ελληνικός
hellenistisch	ελληνιστικός
hemmungslos	αδίστακτος
hepatisch	ηπατικός
herab	κάτω
herausgeben	εκδίδω
herbstlich	φθινοπωρινός
hermetisch	ερμητικός
herrschen	βασιλεύω
herstellen	κατασκευάζω
herum	γύρω
herunterladen	κατεβάζω
hervorbringen	βγάζω
herzhaft	γερός
herzlich	εγκάρδιος
herzlichen Glückwunsch	συγχαρητήρια
heterogen	ετερογενής
heterosexuell	ετεροφυλόφιλος
heuer	φέτος
heuristisch	ευρετικός
heute	σήμερα
heutig	σημερινός
hier	εδώ
hierarchisch	ιεραρχικός
hierher	προς τα εδώ
hilflos	αβοήθητος
himmelblau	γαλάζιος
himmlisch	ουράνιος
hinauf	πάνω
hindern	εμποδίζω
hinduistisch	ινδουϊστικός
hinein	μέσα
hingegen	απεναντίας
hinreißen	ενθουσιάζω
hinrichten	εκτελώ
hinten	πίσω
hinzuziehen	συμβουλεύομαι
hirnlos	ανεγκέφαλος
histologisch	ιστολογικός
historisch	ιστορικός
hoch	ψηλός
hochheben	σηκώνω
hochmütig	υπεροπτικός
hochverehrt	αξιότιμος
hoffen	ελπίζω
hohl	κούφιος
homerisch	ομηρικός
homosexuell	ομοφυλόφιλος
horizontal	οριζόντιος
huckepack	πλάτη
humanitär	ανθρωπιστικός
humid	υγρός
hundemüde	κατάκοπος
hundert	εκατό
hunderterste	εκατοστός πρώτος
hundertmal	εκατό φορές
hundertste	εκατοστός
hundertundzweite	εκατοστός δεύτερος
hundertzwei	εκατόν δύο
hundertzweite	εκατοστός δεύτερος
hungrig	νηστικός
hurra	ζήτω
husten	βήχω
hydroponisch	υδροπονικός
hypertroph	υπερτροφικός
hypnotisieren	υπνωτίζω
hysterisch	υστερικός
hängen	κρεμώ
hässlich	άσχημος
häufig	συχνός
höflich	ευγενικός
höhere Gewalt	ανωτέρα βία
hören	ακούω
hügelig	λοφώδης
ich liebe dich	σ’αγαπώ
ideal	ιδανικός
ideologisch	ιδεολογικός
idiomatisch	ιδιωματικός
idiopathisch	ιδιοπαθής
igitt	μπλιάχ
ihn	αυτόν
ihr	εσείς
illegal	παράνομος
illusionär	απατηλός
illustrieren	διευκρινίζω
im Einzelnen	συγκεκριμένα
im Geld schwimmen	κολυμπώ
im Handumdrehen	εν ριπή οφθαλμού
immer	πάντοτε
immergrün	αειθαλής
imperativ	προστακτικός
improvisieren	αυτοσχεδιάζω
in	σε
in der Regel	κανόνας
in einem Zug	μονορούφι
inbegriffen	συμπεριλαμβανόμενος
indianisch	ινδιάνικος
indigniert	αγανακτισμένος
indirekt	έμμεσος
indisch	ινδικός
individuell	προσωπικός
indonesisch	ινδονησιακός
industriell	βιομηχανικός
inklusive	συμπεριλαμβανομένος
insektenfressend	εντομοφάγος
insgesamt	συνολικά
instand setzen	επισκευάζω
integrieren	ενσωματώνω
intelligent	ευφυής
intelligibel	κατανοητός
intensiv	έντονος
interessant	ενδιαφέρων
interessieren	ενδιαφέρω
interkulturell	διαπολιτιστικός
international	διεθνής
interstellar	διάστερος
interventionistisch	παρεμβατικός
intestinal	εντερικός
intransitiv	αμετάβατος
involvieren	μπλέκω
iranisch	ιρανικός
irgendwie	κάπως
irgendwo	κάπου
ironisch	ειρωνικός
irrational	άρρητος
irreal	εξωπραγματική
islamisch	ισλαμικός
islamistisch	ισλαμιστικός
isochor	ισόχωρος
isolieren	απομονώνω
israelisch	ισραηλινός
italienisch	ιταλικός
iterativ	επαναλαμβανόμενος
ja	ναι
ja	ναι
jagen	κυνηγώ
jamaikanisch	τζαμαϊκανός
jammern	γκρινιάζω
janusköpfig	διπρόσωπος
japanisch	ιαπωνικός
jeder	κάθε
jeder Hans findet seine Grete	βρήκε ο Φίλιππος τον Ναθαναήλ
jeder Topf findet seinen Deckel	βρήκε η τέντζερη το καπάκι
jemals	ποτέ
jemand	κάποιος
jetzt	τώρα
journalistisch	δημοσιογραφικός
jugendlich	νεαρός
jugoslawisch	γιουγκοσλαβικός
jung	νέος
juristisch	νομικός
jährlich	ετήσιος
jäten	ξεχορταριάζω
jüdisch	εβραϊκός
kacken	χέζω
kahl	φαλακρός
kaiserlich	αυτοκρατορικός
kalfatern	καλαφατίζω
kalken	ασβεστώνω
kalt	κρύος
kaltlassen	αδιάφορος
kanadisch	καναδέζικος
kanonisch	κανονικός
kapern	καταλαμβάνω
kaputt	χαλασμένος
kaputtmachen	χαλώ
kasachisch	κοζάκικος
kastanienbraun	καστανός
katalytisch	καταλυτικός
katholisch	καθολικός
kauen	μασάω
kaufen	αγοράζω
kaum	μόλις
kauterisieren	καυτηριάζω
keimtötend	αποστειρωτικός
kein	κανένας
keine Ursache	τίποτα
keiner	κανείς
keltisch	κελτικός
kennen	γνωρίζω
kerben	χαράζω
kerngesund	υγιέστατος
ketzerisch	αιρετικός
keuchen	λαχανιάζω
keusch	αγνός
kiffen	καπνίζω
kikeriki	κικιρίκου
kirchlich	εκκλησιαστικός
kitzeln	γαργαλώ
klatschen	χειροκροτώ
klatschnass	καταβρεγμένη
kleben	κολλώ
klein	μικρός
kleiner Finger	μικρός
kleinkariert	καρό
klicken	κλικάρω
klipp und klar	καθαρά και ξάστερα
klopfen	χτυπώ
klug	έξυπνος
klösterlich	μοναστηριακός
knapp	ανεπαρκής
kneten	ζυμώνω
knusprig	τραγανιστός
kochen	μαγειρεύω
koffeinhaltig	καφεϊνούχος
kollabieren	καταρρέω
kombinieren	συνδυάζω
kommen	έρχομαι
kommentieren	σχολιάζω
kommunistisch	κομμουνιστικός
kommunizieren	επικοινωνώ
kommutativ	αντιμεταθετικός
kompetent	αρμόδιος
komplett	ακέραιος
komplettieren	ολοκληρώνω
komplex	πολύπλοκος
komplexe Zahl	μιγαδικός αριθμός
kondolieren	συλλυπητήρια
konjugieren	κλίνω
konkav	κοίλος
konkret	συγκεκριμένος
konservativ	συντηρητικός
konstitutionell	συνταγματικός
konstitutionelle Monarchie	συνταγματική μοναρχία
kontra	εναντίον
konvex	κυρτός
koptisch	κοπτικός
koreanisch	κορεατικός
korrekt	σωστός
korrespondieren	αλληλογραφώ
korrigieren	διορθώνω
kostbar	πολύτιμος
kosten	κοστίζω
kostspielig	δαπανηρός
kotzen	ξερνώ
krank	άρρωστος
kreativ	δημιουργικός
kretisch	κρητικός
kreuzen	διασταυρώνω
kritisieren	επικρίνω
kryophil	κρυόφιλος
kryptisch	κρύπτoς
krächzen	κρώζω
kränkeln	φιλάσθενος
krümeln	θρυμματίζομαι
kultisch	λατρευτικός
kultivieren	καλλιεργώ
kultiviert	καλλιεργημένος
kulturell	πολιτιστικός
kursiv	πλάγιος
kurz	κοντός
kurz angebunden	απότομος
kurzschließen	βραχυκυκλώνω
kurzsichtig	μυωπικός
kurzärmelig	κοντομάνικος
kämmen	χτενίζω
kämpfen	παλεύω
königlich	βασιλικός
können	μπορώ
köpfen	αποκεφαλίζω
körperlich	σωματικός
künstlerisch	καλλιτεχνικός
künstlich	τεχνητός
küssen	φιλώ
labialisieren	χειλικοποιώ
lachen	γελώ
lakonisch	λακωνικός
lamentieren	γκρινιάζω
landwirtschaftlich	γεωργικός
lang	μακρύς
lange	πολύ
langfristig	μακροπρόθεσμος
langlebig	μακρόβιος
langsam	αργός
langweilen	βαριέμαι
langweilig	βαρετός
langwierig	μακροχρόνιος
laryngeal	λαρυγγικός
lassen	αφήνω
lateinisch	λατινικός
lateral	πλευρικός
lau	χλιαρός
laufen	τρέχω
laut	δυνατός
lauter	ειλικρινής
lauter	μόνο
lautlos	αθόρυβος
lautmalerisch	ονοματοποιετικος
lauwarm	χλιαρός
leben	ζω
lebendes Fossil	ζωντανό απολίθωμα
lebendig	ζωντανός
lebhaft	ζωηρός
lecken	γλείφω
lecker	νόστιμος
ledig	ανύπαντρος
leer	κενός
leeren	αδειάζω
legalisieren	νομιμοποιώ
lehren	διδάσκω
leicht	ελαφρός
leiden	υποφέρω
leidenschaftlich	παράφορος
leider	δυστυχώς
leidtun	λυπάμαι
lernen	μαθαίνω
lesbisch	λεσβιακός
lesen	διαβάζω
letzte	τελευταίος
libanesisch	λιβανέζικος
libysch	λιβυκός
lieb haben	αγαπώ
lieben	αγαπώ
liebenswert	αξιαγάπητος
liebevoll	στοργικός
lindern	ανακουφίζω
linear	γραμμικός
links	αριστερά
lipophil	λιπόφιλος
litauisch	λιθουανικός
lithographieren	λιθογραφώ
loben	επαινώ
lobenswert	αξιέπαινος
lodern	φουντώνω
lokal	τοπικός
lokalisieren	εντοπίζω
lutherisch	λουθηρανικός
lächeln	χαμογελώ
lächerlich	γελοίος
ländlich	αγροτικός
lösbar	λύνω
löschen	σβήνω
löten	συγκολλώ
lügen	ψέμα
machen	κάνω
mahlen	αλέθω
malen	τραβώ
malerisch	ζωγραφικός
maltesisch	μαλτέζικος
manchmal	κάποτε
mangelhaft	ελλιπής
manieriert	επιτηδευμένος
manipulieren	χειραγωγώ
mannhaft	παλικαρίσιος
marginal	περιθωριακός
marginalisieren	περιθωριοποιώ
marinieren	μαρινάρω
maritim	θαλάσσιος
marokkanisch	μαροκινός
mathematisch	μαθηματικός
mausetot	νεκρός
mauve	μοβ
maxillar	γναθιαίος
maßlos	τεράστιος
mea culpa	ήμαρτον
mechanisch	μηχανικός
medizinisch	ιατρικός
mehlieren	αλευρώνω
mehlig	αλευρωμένος
mehr	παραπάνω
mehr	περισσότερος
mehrsilbig	πολυσύλλαβος
mehrteilig	πολυμερής
mehrtägig	πολυήμερος
mein	μου
meistens	συνήθως
meißeln	λαξεύω
melken	αρμέγω
mens sana in corpore sano	νους υγιής εν σώματι υγιεί
menschlich	ανθρώπινος
menschlicher Schutzschild	ανθρώπινη ασπίδα
merklich	αισθητός
messen	μετρώ
metallisch	μεταλλικός
metaphorisch	μεταφορικός
mexikanisch	μεξικανικός
miau	νιάου
mich	εμένα
mieten	ενοικιάζω
militärisch	στρατιωτικός
milliardste	δισεκατομμυριοστός
milliardstel	δισεκατομμυριοστός
minderjährig	ανήλικος
mindestens	τουλάχιστον
minoisch	μινωικός
mir	εμένα
mischen	ανακατεύω
miserabel	άθλιος
missgünstig	ζηλόφθονος
misshandeln	κακοποιώ
missliebig	αντιπαθής
missverständlich	παρεξηγήσιμος
mit	με
mitbestimmen	συναποφασίζω
mitmachen	συμμετέχω
mittags	μεσημεριάτικα
mitteilen	πληροφορώ
mittel	μέσος
mittelalterlich	μεσαιωνικός
mittelmäßig	μέτριος
modern	μοντέρνος
modifizieren	τροποποιώ
molekular	μοριακός
monatlich	μηνιαίος
monotheistisch	μονοθεϊστικός
morgen	αύριο
morgens	το πρωί
morgig	αυριανός
muh	μου
multikulturell	πολυπολιτισμικός
multinational	πολυεθνικός
musikalisch	μουσικός
muslimisch	μουσουλμανικός
mutig	θαρραλέος
mykenisch	μυκηναϊκός
mysteriös	μυστηριώδης
mystisch	μυστικιστικός
mächtig	ισχυρός
männlich	αρσενικός
müde	κουρασμένος
mühen	μοχθώ
mündig	ενήλικος
mündlich	προφορικός
mürrisch	γκρινιάρης
müssen	πρέπει
mütterlich	μητρικός
nach	σε
nach Lust und Laune	ανάλογα με το κέφι
nach und nach	σιγά σιγά
nacharbeiten	αναπληρώνω
nachdem	αφού
nachdenken	σκέφτομαι
nachempfinden	μιμούμαι
nachgiebig	υποχωρητικός
nachhallen	αντηχώ
nachplappern	παπαγαλίζω
nachspionieren	κατασκοπεύω
nachträglich	καθυστερημένος
nachts	νυχτιάτικα
nachvollziehbar	κατανοητός
nachäffen	μαϊμουδίζω
nackt	γυμνός
nageln	καρφώνω
nagelneu	ολοκαίνουργιος
nahe	κοντινός
nahe	κοντά
nappieren	επικαλύπτω
nasal	ρινικός
nass	υγρός
natürliche Person	φυσικό πρόσωπο
nautisch	ναυτικός
neben	δίπλα
negativ	αρνητικός
nehmen	παίρνω
neidisch	ζηλιάρης
nein	όχι
nennenswert	αξιόλογος
nerven	νευριάζω
nervös	νευρικός
neu	νέος
neugeboren	νεογέννητος
neugierig	περίεργος
neun	εννέα
neunhundert	εννιακόσια
neunte	ένατος
neunundneunzig	ενενήντα εννέα
neunundzwanzig	είκοσι εννέα
neunzehn	δεκαεννιά
neunzig	ενενήντα
neunzigste	ενενηκοστή
neuralgisch	νευραλγικός
neureich	νεόπλουτος
neuseeländisch	νεοζηλανδικός
neutral	ουδέτερος
nicaraguanisch	Νικαραγουανός
nicht	δεν
nicht nur … sondern auch	όχι μόνο … αλλά και
nichts	τίποτα
nichts zu melden haben	δεν περνάει ο λόγος μου
nie	ποτέ
nie und nimmer	ποτέ
niederländisch	ολλανδικός
niedrig	χαμηλός
niemals	ποτέ
niemand	κανένας
nieseln	ψιχαλίζει
niesen	φτερνίζομαι
nisten	φωλιάζω
noch	ακόμα
nominalisieren	ουσιαστικοποιώ
nonchalant	νωχελικός
nordeuropäisch	βορειοευρωπαϊκός
nordwestlich	βορειοδυτικός
nordöstlich	βορειοανατολικός
normal	κανονικός
normalerweise	κανονικά
norwegisch	νορβηγικός
notlanden	προσγειώνομαι
notwendig	απαραίτητος
notwendigerweise	αναγκαστικά
nuklear	πυρηνικός
null	μηδέν
nur	μόνο
nur über meine Leiche	πάνω από το πτώμα μου
nähen	ράβω
nähern	πλησιάζω
nämlich	δηλαδή
nörgeln	γκρινιάζω
nötig	απαραίτητος
nüchtern	νηφάλιος
nützlich	χρήσιμος
ob	αν
obdachlos	άστεγος
oben	πάνω
oberflächlich	ρηχός
oberhalb	πάνω
obligatorisch	υποχρεωτικός
obschon	αν και
obwohl	αν και
oder	ή
offen	ανοιχτός
offener Brief	ανοιχτή επιστολή
offiziell	επίσημος
oft	συχνά
ohne	χωρίς
ohne Schweiß kein Preis	τα αγαθά κόποις κτώνται
okay	εντάξει
okkult	αποκρυφιστικός
omnivor	παμφάγος
operativ	χειρουργικός
opfern	θυσιάζω
oral	στοματικός
orange	πορτοκαλί
ordentlich	τακτοποιημένος
ordinär	κοινός
organisch	οργανικός
organische Chemie	οργανική χημεία
orientalisch	ανατολίτικος
original	αρχικός
ornithologisch	ορνιθολογικός
ortho-	ορθο-
orthodox	ορθόδοξος
osmotisch	ωσμωτικός
ostslawische Sprache	ανατολική σλαβική γλώσσα
ovarial	ωοθηκικός
paläozoisch	παλαιοζωικός
palästinensisch	παλαιστινιακός
paradiesisch	παραδεισένιος
paranoid	παρανοϊκός
paraxial	παραξονικός
parken	παρκάρω
parodieren	παρωδώ
passend	κατάλληλος
passieren	συμβεί
pathologisch	παθολογικός
patriotisch	πατριωτικός
pellen	ξεφλουδίζω
perkutan	διαδερμικός
perlen	στάζω
personalisieren	εξατομικεύω
pfeffern	πιπερώνω
pfeifen	σφυρίζω
pflanzen	φυτεύω
philosophisch	φιλοσοφικός
phlegmatisch	φλεγματικός
phonetisch	φωνητικός
picken	τσιμπώ
platonische Liebe	πλατωνικός έρωτας
platt	πλατιά
plosiv	κλειστός
plätschern	φλοισβίζω
plötzlich	ξαφνικός
plündern	λεηλατώ
poetisch	ποιητικός
politisch	πολιτικός
polnisch	πολωνικός
polytheistisch	πολυθεϊστικός
polytrop	πολυτροπικός
polyzyklisch	πολυκυκλικός
porträtieren	προσωπογραφώ
portugiesisch	πορτογαλικός
positiv	θετικός
postalisch	ταχυδρομικός
praktisch	πρακτικός
preisgekrönt	βραβευμένος
preußisch	πρωσικός
probieren	δοκιμάζω
produzieren	παράγω
programmieren	προγραμματίζω
promenieren	περιπατώ
promovieren	διατριβή
prost	υγεία
prußisch	πρωσικός
prädikativ	κατηγορηματικός
prägen	κόβω
prähistorisch	προϊστορικός
präsumtiv	υποτιθέμενος
prüde	σεμνότυφος
psychiatrisch	ψυχιατρικός
psychologisch	ψυχολογικός
psychopathisch	ψυχοπαθής
puh	ουφ
pulmonal	πνευμονικόσ
purzeln	κυλιέμαι
quasi-	οιονεί
quellen	φουσκωμα νμζ χαχαχ
radikal	ριζοσπαστικός
radioaktiv	ραδιενεργός
randständig	περιθωριακός
rangeln	παλεύω
rasend	μαινόμενος
rasieren	ξυρίζω
rationale Zahl	ρητός
rationieren	διανέμω με δελτίο
rauchen	καπνίζω
rausschmeißen	διώχνω
reagieren	αντιδρώ
realistisch	ρεαλιστικός
rechnen	υπολογίζω
recht	δεξιός
rechteckig	ορθογώνιος
rechts	δεξιά
rechtzeitig	ακριβής
recyceln	ανακυκλώνω
referieren	αναφέρομαι
reflexiv	αυτοπαθής
reformieren	μεταρρυθμίζω
regional	τοπικός
regnerisch	βροχερός
reiben	τρίβω
reich	πλούσιος
reif	ώριμος
reimportieren	επανεισάγω
reisen	ταξιδεύω
reiten	ιππεύω
rekapitulieren	ανακεφαλαιώνω
relativ	σχετικός
religiös	θρησκευτικός
rennen	τρέχω
renovieren	ανακαινίζω
reorganisieren	αναδιοργανώνω
reparieren	επισκευάζω
reprivatisieren	επανιδιωτικοποιώ
residieren	εδρεύω
retten	σώζω
revolutionär	επαναστατικός
reziprok	αμοιβαίος
richtig	σωστός
riechen	μυρίζω
riskieren	διακινδυνεύω
ritterlich	ιπποτικός
roh	ωμός
romanische Sprache	ρομανική γλώσσα
romantisch	ρομαντικός
rosa	ροζ
rosig	ρόδινος
rot	κόκκινος
rudern	κωπηλατώ
rufen	καλώ
ruhig	ήρεμος
rund	στρογγυλός
rundlich	στρογγυλωπός
russisch	ρωσικός
rußig	αιθαλώδης
rächen	εκδικούμαι
römisch	ρωμαϊκός
röntgen	ακτινοσκοπώ
rösten	ξεροψήνω
rückerstatten	επιστρέφω
rückgängig	πτωτικός
rühren	συγκινώ
rülpsen	ρεύομαι
sachlich	αντικειμενικός
saftig	χυμώδης
sagen	λέω
salzen	αλατίζω
salzig	αλμυρός
samt	μαζί με
samten	βελούδινος
samtig	βελούδινος
samtweich	βελούδινος
sarkastisch	σαρκαστικός
satanisch	σατανικός
sauer	ξινός
sauerstoffhaltig	οξυγονούχος
sauerstoffreich	οξυγονωμένος
schachmatt	ματ
schade	κρίμα
schaffen	δημιουργώ
scharf	κοφτερός
schattig	σκιερός
schaufeln	φτυαρίζω
scheiden	χωρίζω
scheinen	λάμπω
schenken	δωρίζω
scheren	κουρεύω
schicken	στέλνω
schielen	λοξοκοιτάζω
schießen	πυροβολώ
schippen	φτυαρίζω
schlachten	σφάζω
schlafen	κοιμάμαι
schlagen	χτυπάω
schlammig	λασπωμένος
schlank	λεπτός
schlau	πονηρός
schlecht	κακός
schlenkern	κουνιέμαι
schleppen	κουβαλώ
schlicht	απλός
schließen	κλείνω
schließlich	τελικά
schlingen	καταβροχθίζω
schlucken	καταπίνω
schläfrig	νυσταγμένος
schmelzen	λιώνω
schmerzen	πονώ
schmutzig	βρόμικος
schnarchen	ροχαλίζω
schneiden	κόβω
schneien	χιονίζει
schnell	γρήγορος
schnurren	γουργουρίζω
schon	ήδη
schrecklich	τρομερός
schreiben	γράφω
schriftlich	γραπτός
schräg	λοξή
schulden	χρωστώ
schulen	εκπαιδεύω
schutzlos	απροστάτευτος
schwach	αδύναμος
schwanger	έγκυος
schwarz	μαύρος
schwedisch	σουηδικός
schweflige Säure	θειώδες οξύ
schweigen	σιωπώ
schweizerisch	ελβετικός
schweißen	συγκολλώ
schwer	βαρύς
schwierig	δύσκολος
schwimmen	κολυμπώ
schwitzen	ιδρώνω
schwuppdiwupp	άψε σβήσε
schwätzen	κουτσομπολεύω
schwören	ορκίζομαι
schälen	ξεφλουδίζω
schämen	ντρέπομαι
schön	όμορφος
schüchtern	ντροπαλός
schütten	χύνω
sechs	έξι
sechste	έκτος
sechsundzwanzig	είκοσι έξι
sechzehn	δεκαέξι
sechzehnte	δέκατος έκτος
sechzig	εξήντα
sechzigste	εξηκοστός
seelisch	ψυχικός
segeln	ιστιοπλοΐα
sehen	βλέπω
sehenswert	αξιοθέατος
sehr	πολύ
sein	είμαι
seit	αφότου
seit	από
selbstredend	φυσικά
selten	σπάνιος
seltsam	παράξενος
semantisch	σημασιολογικός
senden	στέλνω
sentimental	συναισθηματικός
serbisch	σερβικός
setzen	βάζω
seufzen	αναστενάζω
sexuell	γενετήσιος
sich mit fremden Federn schmücken	στολίζομαι με ξένες δάφνες
sicher	σίγουρος
siderisch	αστρικός
sie	αυτή
sieben	επτά
sieben	κοσκινίζω
siebenundzwanzig	είκοσι επτά
siebte	έβδομος
siebzehn	δεκαεπτά
siebzig	εβδομήντα
siebzigste	εβδομηκοστός
siedeln	εγκαθίσταμαι
sieden	βράζω
siezen	πληθυντικός
signalisieren	δείχνω
silbern	αργυρός
silbisch	συλλαβικός
singen	τραγουδώ
sittlich	ηθικός
sitzen	κάθομαι
sizilianisch	σικελικός
skandinavisch	σκανδιναβικός
skizzieren	ιχνογραφώ
skrupellos	αδίστακτος
slawisch	σλαυικός
slawische Sprache	Σλαβικές γλώσσες
slowakisch	σλοβακικός
so	έτσι
so lala	έτσι κι έτσι
so weit das Auge reicht	όσο μακριά φτάνει το βλέμμα
sobald	μόλις
soeben	μόλις
sofort	αμέσως
sofortig	άμεσος
sogenannt	λεγόμενος
somalisch	σομαλικός
sommerlich	θερινός
sommertags	καλοκαιρινός
sondieren	βολιδοσκοπώ
sonnen	λιάζομαι
sonnig	ηλιόλουστος
sorbisch	σορβικός
sorgen	φροντίζω
sortieren	ταξινομώ
souverän	κυρίαρχος
sowie	καθώς και
sowjetisch	σοβιετικός
sowohl … als auch	και … και
sozialistisch	σοσιαλιστικός
spalten	σχίζω
spanisch	ισπανικός
spazieren	περιπατώ
spazieren gehen	κάνω βόλτα
spenden	δωρίζω
spezialisiert	ειδικευμένος
spielen	παίζω
spinal	σπονδυλικόσ
spitz	μυτερός
spontan	αυθόρμητος
sporadisch	σποραδικός
sprechen	μιλάω
springen	πηδώ
spät	αργός
spürbar	αισθητός
staatenlos	ανιθαγενής
staatlich	κρατικός
stabil	ευσταθής
stammen	προέρχομαι
standesamtlich	ληξιαρχικός
standhalten	αντέχω
stark	δυνατός
statistisch	στατιστικός
stehen	στέκομαι
stehlen	κλέβω
steil	απότομος
steinern	πέτρινος
stempeln	σφραγίζω
sterblich	θνητός
stets	πάντα
steuern	κυβερνώ
sticken	κεντώ
stiefmütterlich	άστοργος
stille Wasser sind tief	τα σιγανά ποταμάκια να φοβάσαι
stillen	ικανοποιώ
stimmhaft	ηχηρός
stimmlos	άηχος
stochastisch	στοχαστικός
stoisch	στωικός
stolpern	σκοντάφτω
stolz	περήφανος
stopfen	μαντάρω
stottern	τραυλίζω
strategisch	στρατηγικός
streichen	βάφω
streiken	απεργώ
streng	αυστηρός
streng genommen	βασικά
stromlinienförmig	αεροδυναμικός
studieren	σπουδάζω
stufenlos	αβαθμίδωτος
stumm	βουβός
stumpf	αμβλύς
städtebaulich	πολεοδομικός
städtisch	αστικός
ständig	μόνιμος
stürmen	ορμώ
stürmisch	θυελλώδης
stützen	στηρίζω
subdural	υποσκληρίδιος
subjektiv	υποκειμενικός
substantivieren	ουσιαστικοποιώ
subtrahieren	αφαιρώ
subtropisch	υποτροπικός
suchen	ψάχνω
sym-	συμ-
synchronisieren	συγχρονίζω
synodal	συνοδικός
synonym	συνώνυμος
synthetisch	συνθετικός
syrisch	συριακός
sächlich	ουδέτερος
säen	σπέρνω
sägen	πριονίζω
südkoreanisch	νοτιοκορεατικός
südlich	νότιος
südslawisch	νότιος σλαβικός
südslawische Sprache	nότια σλαβική γλώσσα
sündigen	αμαρτάνω
süß	γλυκός
tagen	ξημερώνει
tagsüber	την ημέρα
tanzen	χορεύω
tapfer	γενναίος
tatarisch	ταταρικός
taub	κουφός
taubstumm	κωφάλαλος
tauchen	βουτώ
taufen	βαφτίζω
tausend	χίλια
tausenderlei	ειδών
tausendste	χιλιοστός
tausendstel	χιλιοστό
teilen	χωρίζω
teilnehmen	συμμετέχω
telefonieren	τηλεφωνώ
tendieren	κλίνω
terroristisch	τρομοκρατικός
teuer	ακριβός
theologisch	θεολογικός
theoretisch	θεωρητικός
tief	βαθύς
tiefkühlen	καταψύχω
tierisch	ζωώδης
tippen	δακτυλογραφώ
toasten	φρυγανίζω
tolerieren	ανέχομαι
tollkühn	ριψοκίνδυνος
tot	νεκρός
totaler Krieg	ολοκληρωτικός πόλεμος
totalitär	ολοκληρωτικός
traditionell	παραδοσιακός
tragen	κουβαλώ
transformieren	μετασχηματίζω
transitiv	μεταβατικός
transportieren	μεταφέρω
trauen	παντρεύω
trauern	πενθώ
traurig	θλιβερός
treffen	συναντώ
treten	πατώ
treu	πιστός
trillern	τερετίζω
trinken	πίνω
trocken	ξερός
trocknen	στεγνώνω
trojanisch	Τρωϊκός
trotten	τραβώ
trotz	παρά
trotz dass	αν και
trotzen	αντιστέκομαι
trotzig	πεισματάρης
trächtig	έγκυος
träf	εύστοχος
tränken	ποτίζω
träufeln	σταλάζω
träumen	ονειρεύομαι
tschüs	αντίο
tun	κάνω
tunesisch	τυνησιακός
tunken	βουτώ
täglich	ημερήσιος
täglich	καθημερινός
tätlich	βίαιος
tätowieren	τατουάζ
tödlich	θανατηφόρος
tönern	πήλινος
töten	σκοτώνω
türkis	γαλάζιος
türkisch	τουρκικός
ukrainisch	ουκρανικός
ultraviolett	υπεριώδης
um	γύρω
umarmen	αγκαλιάζω
umbringen	σκοτώνω
umgangssprachlich	καθομιλουμένη
umsichtig	προσεκτικός
umsteigen	μετεπιβιβάζομαι
umziehen	μετακομίζω
umzäunen	περιφράζω
un-	α-
unabhängig	ανεξάρτητος
unangenehm	δυσάρεστος
unangreifbar	απρόσβλητος
unauflöslich	αδιάλυτος
unbedeutend	ασήμαντος
unbegrenzt	απεριόριστος
unbekannt	άγνωστος
unbemerkt	απαρατήρητος
unbequem	άβολος
unbesiegbar	ανίκητος
unbestimmter Artikel	αόριστο άρθρο
unbeständig	άστατος
unbewohnt	ακατοίκητος
unbußfertig	αμετανόητος
und	και
undeutlich	δυσανάγνωστος
undurchdringlich	αδιαπέραστος
undurchschaubar	ανεξιχνίαστος
unentbehrlich	απαραίτητος
unerlaubt	αυθαίρετος
unerlässlich	απαραίτητος
unermesslich	αμέτρητος
unerschütterlich	ατράνταχτος
unerträglich	ανυπόφορος
unerwartet	απροσδόκητος
unerwünscht	ανεπιθύμητος
unfruchtbar	άγονος
ungarisch	ουγγρικός
ungeeignet	ακατάλληλος
ungefähr	περίπου
ungefährlich	ακίνδυνος
ungehalten	αγανακτισμένος
ungehorsam	ανυπάκουος
ungesäuert	άζυμος
ungewohnt	ασυνήθιστος
unglückseligerweise	δυστυχώς
ungültig	άκυρος
unklar	ασαφής
unkritisch	άκριτος
unmenschlich	απάνθρωπος
unmöglich	αδύνατος
unparteiisch	αμερόληπτος
unpassend	ακατάλληλος
unpersönlich	απρόσωπος
unpässlich	ανήμπορος
unsagbar	ανείπωτος
unser	μας
unsichtbar	αόρατος
unsinkbar	αβύθιστος
unsterblich	αθάνατος
unten	κάτω
unter	κάτω
unter anderem	μεταξύ άλλων
unter den Blinden ist der Einäugige König	στη χώρα των τυφλών, ο μονόφθαλμος είναι βασιλιάς
unterhalb	κάτω
unterirdisch	υπόγειος
unterscheiden	διακρίνω
unterschiedlich	διαφορετικός
unterschreiben	υπογράφω
unterschätzen	υποτιμώ
unterstreichen	υπογραμμίζω
unterstützen	υποστηρίζω
untersuchen	εξετάζω
unterteilen	υποδιαιρώ
unterwerfen	υποτάσσω
unterzeichnen	υπογράφω
unvermindert	αμείωτος
unverständlich	ακατανόητος
unverzichtbar	απαραίτητος
unvorhergesehen	απρόβλεπτος
unwahrscheinlich	απίθανος
unwichtig	ασήμαντος
unwiderstehlich	ακαταμάχητος
unzertrennlich	αχώριστος
unzugänglich	απρόσιτος
unzureichend	ανεπαρκής
unzählig	αμέτρητος
urinal	ουρικός
urinieren	κατουρώ
ursprünglich	αρχικóς
usurpieren	σφετερίζομαι
vakant	ελεύθερος
vegan