ABC	alfabet
Africa	Afrika
African	afrikansk
All	allhelgonadag
All	allhelgonadag
American	amerikansk
American	indian
Annunciation	bebådelsedag
Antarctic	Sydpolen
April	april
Arab	arab
Arabian	arabisk
Arabic	arabisk
Arctic	Nordpolen
Arctic	Ishavet
Armenia	Armenien
Ascension	Kristihimmelsfärdsdag
Asia	Asien
Asian	asiatisk
Asiatic	asiatisk
Atlantic	Atlanten
Atlantic	Atlanten
August	augusti
Australia	Australien
Australian	australisk
Austria	Österrike
Austrian	ostron
Baltic	baltisk
Baltic	Östersjön
Bavaria	Bajern
Bavarian	bajersk
Belgian	belgisk
Belgium	Belgien
Berlin	berlinsk
Bible	Bibel
Brazil	Brasilien
Brazilian	brasiliansk
Britain	Brittannien
British	brittisk
Briton	britt
Brussels	brysselkål
Bulgaria	Bulgarien
Canadian	kanadensare
Caspian	Kaspiskahavet
Catholic	katolik
Chinaman	kines
Chinese	kinesisk
Christ	Kristus
Christian	kristen
Christianity	kristendom
Christmas	jul
Copenhagen	Köpenhamn
Dalecarlia	Dalarna
Dane	dansk
Danish	dansk
December	december
Denmark	Danmark
Dutch	holländsk
Dutchman	holländare
East	orient
Easter	påsk
Egypt	Egypten
England	England
English	engelsk
Englishman	engelsman
Epiphany	trettondag
Eskimo	eskimå
Estonia	Estland
Europa	Europa
Europe	Europa
European	europeisk
Far	Ytterstaöstern
February	februar
Finland	Finland
Finn	finne
Finnish	finsk
Flanders	Flandern
Flemming	flamländare
France	Frankrike
French	fransk
Frenchman	fransman
Frenchwoman	fransyska
French	franska
Friday	fredag
Frisian	fris
German	tysk
Germanic	germansk
Germany	Tyskland
German	tyska
God	Gud
God	kyrkogård
Good	långfredag
Great	Brittannien
Greece	Grekland
Greek	grekisk
Greek	grekinna
Gulf	Bottenviken
Gypsy	tattare
H	vätebomb
Hebrew	judisk
Holland	Holland
Hollander	holländare
Hungarian	ungrare
Hungary	Ungern
Iceland	Island
Icelander	islänning
Icelandic	isländsk
India	Indien
Indian	indisk
Indian	majs
Ireland	Irland
Irish	irländsk
Irishman	irländare
Italian	italiensk
Italy	Italien
January	januari
Japanese	japanesisk
Javan	javanesisk
Javanese	javanesisk
Jew	jude
Jewish	judisk
July	juli
June	juni
Lady	bebådelsedag
Lapland	Lappland
Laplander	lapp
Lapp	lappländsk
Lappish	lappländsk
Latvia	Lettland
Little	Rödluva
Little	Snövit
Malay	malajisk
March	mars
Mason	frimurare
Mauretanian	mor
May	maj
Mediterranean	Medelhavet
Mexican	mexikan
Middle	medeltida
Miss	fröken
Mister	herr
Mohammedan	mohammedan
Monday	måndag
Mongolia	Mongoliet
Moor	mor
Mormon	mormon
Moscow	Moskva
Moslem	mohammedan
Mr	herr
Mr	herrskap
Mrs	fru
Muslim	mohammedan
Mussulman	mohammedan
Nazi	nazist
Negro	neger
New	nyår
North	nord
North	Nordamerika
North	Nordsjön
Norway	Norge
Norwegian	norsk
November	november
October	oktober
Oriental	orientalisk
Pacific	Söderhavet
Pacific	Söderhavet
Parisian	parisare
Parthian	andel
Pentecost	pingst
Persian	perser
Poland	Polen
Pole	polack
Polish	polsk
Portuguese	portugis
Protestant	protestant
Prussian	preussare
Rhine	rensktvin
Rhine	Rhen
Roman	romersk
Romania	Rumänien
Romanian	rumänsk
Rome	Rom
Rumanian	rumänsk
Russia	Ryssland
Russian	rysk
Sabbath	sabbat
Salvation	frälsningsamé
Sassenach	engelsman
Saturday	lördag
Scandinavia	Norden
Scandinavian	nordisk
Scot	skotte
Scotland	Skottland
Scotsman	skotte
Scottish	skotsk
Semitic	semitisk
September	september
Serb	serbisk
Siberia	Siberien
Siberian	siberisk
Sicily	Sicilien
Slavic	slavisk
South	Sydamerika
Spain	Spanien
Spaniard	spanjor
Spitsbergen	Spetsbergen
Sunday	söndag
Swede	svensk
Sweden	Sverige
Swedish	svensk
Swedish	svenska
Swiss	schweizisk
Switzerland	Schweiz
TV	television
Teutonic	germansk
Thursday	torsdag
Tuesday	tisdag
Turk	turk
Turkey	Turkiet
Twelfth	trettondag
USA	Förentastaterna
US	amerikan
Ukraine	Ukraina
United	Förentastaterna
Volt	volt
Walloon	vallon
Wednesday	onsdag
Wee	JonBlund
West	väst
West	Västindien
Whitsunday	pingst
Xanthippe	ragata
Yule	jul
ZIP	postnummer
a	i
abandon	lämna
abandoned	skamlös
abase	förnedra
abasement	förödmjukelse
abashed	blyg
abattoir	slakthus
abbess	abbedissa
abbey	abbotskloster
abbot	abbot
abdomen	buk
aberration	fel
abhor	avsky
abide	forvänta
ability	makt
abject	nedrig
abjure	arbeställa
able	kompetent
abnormal	abnorm
abode	boning
abolish	arbeställa
abominate	avsky
aboriginal	inhemsk
abort	klicka
abortion	abort
about	förändring
about	angående
above	redlig
above	norrom
abrade	hyvla
abridge	avgränsa
abroad	ute
abrogate	arbeställa
abrupt	oförhoppandes
absence	frånvaro
absent	frånvarande
absent	gesigiväg
absolute	absolut
absolutely	sannerligen
absolution	benådning
abstraction	stöld
abstruse	mysteriös
abundance	rikedom
abuse	skällaut
abysmal	hopplös
abyss	avgrund
academic	student
academy	akademi
accelerator	gastrampa
accelerator	gastrampa
accent	accent
accept	tackajatill
acceptance	accept
access	anfall
accession	förvärv
accidence	slump
accident	ofall
acclaim	applådera
acclamation	applåd
accommodating	behjälplig
accommodation	inredning
accomodate	fullborda
accompaniment	ackompanjemang
accomplish	ernå
accomplished	kompetent
accomplishment	dåd
accord	överenskommelse
accordance	överenskommelse
according	alltefter
according	alltefter
account	explikation
accountable	förklarlig
accountant	revisor
account	register
account	förklara
accredit	tro
accrue	härstamma
accumulation	hop
accumulator	batteri
accurate	ackurat
accusal	anklagelse
accusation	anklagelse
accusative	ackusativ
accuse	anklaga
accuser	klagande
accustomed	bruklig
acerbic	amper
acerbity	skärpa
ache	smäkta
achievable	görlig
achieve	förvärva
achievement	gärning
achromatic	färglös
acid	syra
acidify	surna
acknowledge	erkänna
acknowledgement	bekännelse
acorn	ekollon
acquaint	tillkännagiva
acquaintance	bekant
acquire	förvärva
acquirement	ackvisition
acquisition	ackvisition
acquisitive	begärlig
acquittal	avbetalning
acrimony	skärpa
across	emot
act	gärning
action	gärning
activate	föranleda
active	aktiv
actor	aktör
actress	aktris
actual	faktisk
acuity	skärpa
ad	anmälan
adage	ordspråk
add	addera
adder	huggorm
addition	addition
additional	extra
addled	rutten
address	adressera
address	adresskalender
add	addera
adherents	anhang
adieu	adjö
adjective	adjektiv
adjournment	anstånd
adjudication	dom
adjustment	inredning
adjutant	adjutant
administer	förvalta
administration	regering
administrator	administratör
admiral	amiral
admiration	beundran
admire	beundra
admirer	beundrare
admission	accept
admission	inträdesbiljett
admit	medge
admittance	entré
admixture	röra
admonition	maning
ado	bråk
adopt	adoptere
adore	förära
adorer	tillbedjare
adorn	smycka
adroit	livaktig
adult	myndig
advance	nalkas
advancement	befordran
advantage	fördel
advantageous	fördelaktig
adventure	äventyr
adventurous	äventyrlig
adverb	adverb
adversary	vedersakare
adverse	motsatt
advert	beakta
advertence	väntan
advertency	väntan
advertise	anmäla
advertisement	anmälan
advice	råd
advise	rå
advocate	advokat
aerodrome	flygfält
aeroplane	flygmaskin
affable	snäll
affair	affär
affect	påverka
affectation	affektation
affection	kärlek
affiliation	släkt
affined	anhörig
affinity	släkt
affirm	betrygga
affirmation	löfte
affix	befästa
afflict	bedröva
affluence	rikedom
affluent	rik
afford	alstra
afraid	rädd
afresh	ånyo
after	efter
afternoon	eftermiddag
again	ånyo
against	emot
age	ålder
agency	agentur
agent	agent
aggrandize	förstora
aggravate	förarga
aggravating	anstötlig
aggression	anfall
aggressive	offensiv
aggressor	angripare
agile	livaktig
agitated	nervös
agitation	agitation
agog	frågvis
agonize	martera
agonizing	gruvlig
agony	fruktan
agrarian	jordbrukare
agreeable	angenäm
agreement	överenskommelse
agree	varaenigmed
agriculture	jordbruk
ague	feber
ah	ack
aid	hjälpare
aide	adjutant
ailment	sjuka
air	luft
aircraft	flygplan
airdrome	flygfält
airfield	flygfält
airplane	flygmaskin
airport	flyghamn
airy	gles
akin	anhörig
alacrity	entusiasm
alarm	alarmere
alarmclock	väckarur
alarmed	förfärlig
alas	detvarsynd
alcohol	alkohol
alcoholic	drinkare
alder	al
alderman	rådman
ale	öl
alert	livaktig
alga	alg
alien	främmande
alike	liknande
alimony	underhålla
alive	levande
all	allvetande
all	allrådande
all	allehanda
allegoric	allegorisk
alley	gränd
alliance	allians
alloy	legering
allude	alludera
allusion	anspelning
all	allestädes
all	ånyo
all	varjehanda
all	varjehanda
all	all
all	oavlåtlig
almanac	almanacka
almighty	allrådande
almond	mandel
almost	nästan
alms	allmosa
alone	ensam
alongside	bredvid
alphabet	alfabet
already	allaredan
also	också
altar	altare
alter	förvandla
alteration	ändring
alternative	alternativ
although	ehuru
altitude	höjd
altogether	allting
alum	alun
always	alltid
amateur	amatör
amaze	förvåna
ambassador	sändebud
ambiguous	tvetydig
ambition	ambition
ambitious	ambitiös
ambulance	ambulansbil
ammunition	ammunition
among	emellan
amount	antal
amphitheatre	amfiteatro
ample	omfångsrik
anaemia	anemi
analogy	analogi
analysis	analys
anarchist	anarkist
anatomical	anatomisk
anchor	ankare
anchorage	redd
anchovy	ansjovis
and	och
anecdote	anekdot
anemone	sippa
anew	ånyo
angel	ängel
angle	hörn
angry	arg
anguish	fruktan
animal	djurisk
anise	anis
ankle	ankel
annotation	anteckning
announce	anmäla
announcement	bekantgörande
annoy	förarga
annul	arbeställa
anonymous	anonym
another	annan
answer	svara
ant	myra
anthem	hymn
antidote	motgift
antique	antikvitetshandlare
antithesis	motsats
anvil	städ
any	någon
anybody	någon
anything	någonting
anywhere	någonstans
apart	särskild
apartment	lägenhet
apartment	höghus
apart	utom
ape	apa
apiarist	biodlare
apologize	ursäktesig
apostle	apostel
apparatus	apparat
appeal	appell
appeal	anropa
appear	synas
appearance	anblick
appear	synas
appellation	namn
appetite	aptit
applaud	applådera
apple	äppelmos
apple	äppelkaka
apple	apel
apple	äpple
appraise	beräkna
appraiser	värderingsman
appreciate	värdesätta
apprehension	häkte
approach	annalkande
approval	applåd
approve	godkänna
approximately	cirka
apricot	aprikos
aptitude	begåvning
aqueduct	akvedukt
arc	båge
archangel	ärkeängel
archbishop	ärkebiskop
archipelago	arkipelag
architect	arkitekt
archive	arkiv
archives	arkiv
archivist	arkivarie
are	flock
area	areal
arithmetic	aritmetik
arm	beväpna
armchair	emma
armpit	armhåla
army	armé
around	kring
arouse	väcka
arrange	arrangera
arrangement	inredning
arrest	anhålla
arrival	ankomst
arrive	ankomma
arrow	pil
art	konst
artery	artär
arthritis	gikt
artichoke	kronärtskocka'ärtskocka
article	artikel
artificial	artificiell
artillery	artilleri
artist	artist
as	hur
ascend	dala
ascetic	asketisk
ash	aska
ashtray	askkopp
ask	fråga
ask	anmoda
ask	beomursäkt
asparagus	sparris
aspect	anblick
aspen	asp
asphalt	jordbeck
ass	åsna
assailant	angripare
assault	anfalla
assemblage	församling
assemble	montera
assent	bejaka
assert	hävda
assertion	påstående
asset	ackvisition
assist	biträda
assistent	hjälpare
associate	para
associate	haettförhållandemed
assortment	sortiment
assure	betrygga
aster	aster
astonishment	förvåning
astrologer	stjärntydare
astronaut	rymdpilot
astronomy	astronomi
as	lika...som
at	på
atelier	ateljé
atheism	ateism
atheist	ateist
atlas	atlas
atmosphere	atmosfär
atom	atom
atomic	atomkraft
atom	atombomb
attach	befästa
attack	anfalla
attacker	angripare
attain	förvärva
attempt	bemödande
attend	ansa
attention	väntan
attest	attestera
attic	loft
attitude	hållning
attraction	attraktion
attractive	lockande
at	alldeles
at	hemma
at	omnatten
at	nu
at	någonsin
at	där
at	isänder
at	oenig
auction	auktion
audience	auditorium
audit	besiktiga
auditory	auditorium
augment	förstora
aunt	faster
authentic	autentisk
author	auktor
automatic	automatisk
automoton	automat
autumn	höst
avail	gagna
avalanche	bergskred
avaricious	girig
avenge	hämna
avenge	hämna
avenue	allé
average	medeltal
avidity	begär
avoid	kringgå
await	forvänta
awaken	väcka
awareness	medvetande
axe	bila
axis	axel
axle	axel
a	somliga
a	någorlunda
a	länge
baboon	babian
baby	baby
baby	nappflaska
bachelor	ungkarl
back	bak
backbiting	förtal
backpack	ryggsäck
backside	stjärt
backward	bakåt
backwards	bakåt
back	nacke
bacon	fläsk
bacterium	bakterie
bad	arg
badger	grävling
bad	otur
bag	säck
baggage	bagage
bairn	barn
bait	agn
bake	baka
baker	bagare
bakery	bageri
baker	bagarbod
balance	saldo
balance	bokslut
balcony	altan
bale	packe
ball	glob
ball	bal
ballast	ballast
ballet	balett
balloon	ballong
balm	balsam
balsam	balsam
balustrade	balustrad
bamboo	bambu
banana	banan
band	band
bandage	bandage
bandit	bandit
banisters	balustrad
bank	sedel
bank	bank
bankruptcy	bankrutt
bank	bankir
bank	bankir
banner	flagg
banquet	bankett
baptism	dop
baptize	döpa
bar	förhindra
barbarian	barbar
barbaric	barbarisk
barber	frisör
bare	bar
barely	knappast
bark	bark
barley	korn
barn	barack
barometer	barometer
baron	baron
baroness	baronessa
barrack	barack
barracks	kasern
barrel	fat
barren	ofruktbar
barrier	bom
barrister	advokat
barrister	advokat
base	basera
basement	källare
bashfulness	blyghet
basin	bassäng
basket	korg
bass	abborre
bast	bast
bat	flädermus
bath	badkar
bathing	baddräkt
bathing	badhytt
bathing	baddräkt
bathroom	badhus
baton	stav
battalion	bataljon
battery	batteri
battle	batalj
bay	vik
bayonet	bajonett
bazaar	krambod
be	vara
beach	strand
beak	näbb
beam	stråle
bean	böna
bear	alstra
beard	skägg
bear	bekosta
bear	attestera
beast	best
beast	rovdjur
beat	banka
beautiful	skön
beauty	skönhet
beaver	bäver
because	på
become	bli
become	förlovasig
become	förlovasigmed
become	förlovasigmed
become	förlovasigmed
become	giftasigmed
become	giftasigmed
bed	bädd
bedroom	sovrum
bee	biodlare
bee	biodlare
bee	bi
beech	bok
beef	nötkött
beefsteak	biff
beehive	bikupa
beer	öl
beetle	skalbagge
before	förrän
beg	tigga
beggar	tiggerska
beggar	tiggare
begging	tiggeri
begin	begynna
beginner	nybörjare
beginning	begynnelse
behave	betesig
behavior	beteende
behaviour	beteende
behind	efter
belief	övertygelse
believe	tro
believe	tropå
belly	buk
below	nedan
belt	bälte
bench	bänk
bend	krok
beneath	under
benefit	fördel
bent	krokig
berry	bär
beside	bi
besides	utöver
besiege	belägra
best	bäst
bet	tippa
betray	förråda
betrothal	förlovning
better	bättre
between	emellan
beverage	dryck
bevy	flock
bewitch	trolla
be	gitta
be	varaborta
be	känna
be	vararädd
be	leva
be	blygas
be	görakonkurs
be	töras
be	heta
be	varatokigi
be	befinnasig
be	mätta
be	fröjda
be	hungra
be	harmas
be	retasigpå
be	befalla
be	saknas
be	befinnasig
be	hatur
be	giftasig
be	varaborta
be	bevista
be	tiga
be	varasläktmed
be	likna
be	ångra
be	insjukna
be	vilja
be	gälla
biased	partisk
bible	bibel
bicycle	cykel
bid	anmoda
big	stor
bike	cykel
bile	galla
bill	anslagstavia
bill	näbb
billiards	biljard
bind	binda
birch	björk
bird	fågel
birth	börd
birthday	födelsedag
bishop	biskop
bit	bit
bite	bita
bitter	besk
black	svart
blackberry	björnbär
blackberry	björnbär
blackbird	koltrast
bladder	blåsa
blade	klinga
blame	skuld
blank	blank
blanket	dekan
blaspheme	svära
blasphemer	hädare
blasphemy	gudsförmädelse
bleak	förtretlig
bleed	blöda
blend	blanda
bless	signa
blessing	välsignelse
blind	blind
blister	blåsa
block	blockera
blockade	blockad
block	höghus
blond	blond
blood	släkt
blood	blod
bloom	blomma
blot	fläck
blotter	läskpapper
blotting	läskpapper
blouse	blus
blow	hugg
blow	försämra
blue	blå
blueberry	blåbär
blunt	ovass
blushing	röd
board	bräde
boarding	pension
boarding	pension
boast	skryta
boat	båt
bodily	kroppslig
body	kroppslig
body	kroppslig
boil	koka
bold	diger
bolt	regla
bomb	bomb
bone	ben
book	bokförare
bookcase	bokskåp
bookseller	bokhandlare
boon	välsignelse
boot	stövel
boozer	drinkare
border	brädd
bore	borra
borrow	låna
bosom	bröst
boss	anförare
botany	botanik
both	båda
bottle	butelj
bottom	botten
bough	gren
bouillon	buljong
boulevard	bulevard
boundary	gräns
boutique	affär
bovine	nöt
bovine	nöt
bow	båge
bowl	skål
box	förvaringsställe
box	boxa
boy	gosse
bra	behå
brace	spasm
bracelet	armband
bracket	spasm
brag	skryta
brain	hjärna
brake	bromsa
bramble	björnbär
branch	gren
brandish	svinga
brandy	akvavit
brass	mässing
brave	behjärtad
bread	bröd
bread	smörgås
break	paus
breakable	brytbar
break	slopa
bream	braxen
breast	bröst
breath	anda
breathe	andas
breathless	andlös
breed	uppfostra
breeze	bris
brick	tegelsten
bride	fästmö
bridegroom	brudgum
bridge	bro
brief	gen
brief	portfölj
brigade	brigad
bright	ljus
brim	brädd
brimstone	svavel
bring	medbringa
bring	uppfostra
brink	brädd
brisk	livaktig
brittle	brytbar
broad	vid
broadcast	utskicka
broken	kaputt
broker	mäklare
bronze	brons
brooch	brosch
broom	kvast
brothel	bordell
brother	svåger
brother	broder
brothers	syskon
brow	ögonbryn
brown	brun
brush	borsta
brutal	ovänlig
bubble	blåsa
bucket	bytta
bud	knopp
buddy	kamrat
buffalo	buffel
bug	insekt
build	bygga
builder	byggmästare
building	byggnadstomt
building	byggnadstomt
building	byggnad
building	byggmästare
build	snickra
bulk	omfång
bulky	omfångsrik
bull	tjur
bullet	kula
bulletin	bulletin
bumblebee	humla
bump	puckel
bunch	knippa
bundle	knippa
bungalow	enplansvilla
bunker	kasematt
burden	ladda
burdensome	tung
bureau	byrå
burglar	inbrottstjuv
burial	begravning
burn	brinna
burn	förbränna
burst	rämna
bury	begrava
bush	buske
business	affär
businessman	affärsman
business	affär
business	affärsvän
business	affärsförbindelse
but	utom
butcher	slaktare
butcher	slakteri
butter	smör
butterfly	fjäril
button	knapp
buy	anskaffa
buyer	köpare
buzz	surra
by	statut
by	avtagsväg
by	bi
bye	adjö
byname	binamn
by	händelsevis
by	händelsevis
by	per
by	avmisstag
by	omnatten
by	allaredan
by	ingalunda
by	båtledes
by	apropå
cabbage	kål
cabin	hydda
cabinet	kabinett
cable	kabel
cactus	kaktus
cadaver	as
cadger	snyltgäst
caf	kafé
cage	bur
cake	kaka
calculate	beräkna
calculation	beräkning
calendar	kalender
calf	kalv
call	benämna
caller	besökande
call	telefonhytt
camel	kamel
camera	fotografiapparat
camphor	kamfer
camping	kampingplats
camping	kampingplats
canal	grav
canary	kanariefågel
cancel	arbeställa
cancer	kräfta
candidate	sökande
candle	ljus
cane	stav
canker	kräfta
cannibal	kannibal
cannon	kanon
canoe	kanot
canteen	fältflaska
cap	huv
cape	kap
capital	kapital
capital	huvudstad
caprice	hugskott
capsule	kapsyl
captain	kapten
capture	fånga
car	bil
carafe	karaff
caravan	karavan
carburettor	förgasare
card	karta
cardboard	kartong
cardiac	hjärtlig
care	omtanke
career	karriär
careful	försiktig
careless	oaktsam
caress	smeka
carnation	nejlika
carnival	karneval
carp	karp
carpenter	snickare
carrot	morot
carry	bära
case	affär
cashier	kassör
cashier	kassa
casino	kasino
castigate	aga
castigation	aga
castle	borg
cat	katt
catalogue	katalog
catarrh	katarr
catastrophe	katastrof
catch	fånga
category	kategori
caterpillar	larv
cathedral	dom
cauliflower	blomkål
cause	föranleda
cause	bedröva
cause	bedröva
caution	varna
cautious	försiktig
cavalier	riddare
cavalry	kavalleri
cave	grotta
caviar	kaviar
ceaselessly	oavlåtlig
cedar	ceder
cede	cedere
ceiling	tak
celebrate	festa
celebrating	firafödelsedagen
celebration	fest
celery	selleri
celestial	himmelsk
cell	cell
cellar	källare
cello	violoncell
cement	cement
cemetery	kyrkogård
censor	censurera
centennial	århundrade
centimetre	centimeter
centipede	tusenfoting
central	central
centre	center
century	århundrade
ceremony	ceremoni
certain	given
certainly	ju
certainty	visshet
certificate	aktstycke
chain	kedja
chair	stol
chairman	president
chalk	krita
chamber	gemak
champagne	champagne
champion	mästare
chance	slump
change	förvandla
channel	grav
chaos	kaos
chapter	kapitel
character	art
characteristic	karakterisk
characterize	karakterisera
charge	frakt
charity	allmosa
charm	behag
charming	behagfull
chase	driva
chase	förjaga
chasm	avgrund
chaste	kysk
chastise	aga
chastisement	aga
chat	prata
chatter	prata
chauffeur	chaufför
cheap	billig
cheat	niding
check	besiktiga
checker	besiktningsman
check	besiktiga
cheek	kind
cheerful	glad
cheers	gutår
cheese	ost
chemist	apotekare
chemistry	kemi
chemist	apotek
cheque	checkbok
cheque	check
cherry	körsbär
chess	schackbräde
chessboard	schackbräde
chest	bröst
chestnut	kastanje
chewing	tuggummi
chew	idissla
chick	kyckling
chicken	kyckling
chief	anförare
chief	kommissarie
child	telning
childless	barnlös
chilly	kall
chimney	skorsten
chin	haka
chisel	mejsel
chive	gräslök
chlorine	klor
chocolate	choklad
choice	val
choke	strypa
choose	kora
chop	hugga
chord	ackord
chorus	kor
chrestomathy	urval
christen	döpa
christening	dop
chromium	krom
chronicle	krönika
chuck	smeka
church	kyrka
church	kyrka
cigar	cigarr
cigarette	cigarrett
cinder	aska
cinema	biograf
circle	cirkel
circumstances	situation
circus	cirkus
citation	anförande
cite	anföra
citizen	medborgare
city	världsstad
city	rådhus
civil	civilstånd
clamp	spasm
clap	applådera
clarify	förklara
clasp	häkta
class	klass
classic	klassisk
classical	klassisk
claw	klo
clay	ler
clean	lutter
cleanse	luttra
clear	ljus
clef	klav
clergyman	präst
clerk	skrivare
clever	fiffig
client	köpare
client	klientel
climate	klimat
climb	kliva
clinic	klinik
cloak	kappa
cloakroom	garderob
clock	klocka
close	intim
closet	skåp
clothes	garderob
clothes	beklädnad
clothing	beklädnad
cloud	moln
clover	klöver
club	klubb
cluster	knippa
co	sambo
co	medverka
coal	kol
coast	kust
coat	paletå
cock	tupp
cockroach	bobba
cocktail	drink
cocoa	kakao
coconut	kokosnöt
cod	kabeljo
coddle	kela
code	kod
codfish	kabeljo
coffee	kafé
coffee	kaffe
coffin	likkista
cognac	konjak
cohabit	boihop
coin	mynt
coir	kor
cold	kall
collar	krage
colleague	kollega
collect	församla
collection	flock
college	kollegium
colonel	överste
colony	koloni
colossal	kolossal
colour	färg
column	pelare
comb	kamma
combine	ansluta
come	härstamma
comedy	komedi
comet	komet
come	bli
come	möta
come	nalkas
come	nalkas
come	nalkas
come	para
come	sluta
comfort	trösta
comfortable	bekväm
comic	komisk
comical	komisk
coming	ursprunglig
comma	komma
command	befalla
commander	befälhavare
commence	begynna
commencement	begynnelse
commend	berömma
commendable	berömlig
commerce	affär
commission	kommission
committee	kommitté
commodity	artikel
common	gemensam
commonplace	banal
commotion	agitation
communication	bekantgörande
communism	kommunism
community	gemenskap
companion	kamrat
company	affärshus
compare	jämföra
comparison	jämförelse
compartment	fack
compass	kompass
compassion	medlidande
compel	förplikta
compensate	belöna
compensation	belöning
competent	kompetent
competition	konkurrens
complain	klaga
complete	komplett
compliment	komplimang
compose	komponera
composer	kompositör
computation	beräkning
computer	datamaskin
comrade	kamrat
conceal	fördölja
concede	medge
concept	koncept
concern	beträffa
concerning	angående
concert	konsert
conclusion	konklusion
concord	ackord
concrete	betong
concurrence	överenskommelse
condemn	döma
condition	kondition
condom	kondom
conduct	föra
conduct	betesig
confectioner	konditor
confectionery	konditori
confess	bekänna
confession	bekännelse
confide	haförtroendeför
confidence	förtroende
confine	avgränsa
confiscate	konfiskera
conflict	konflikt
congratulate	gratulera
congress	kongress
conifer	barrträd
connect	ansluta
connect	ansluta
conquer	erövra
consciousness	medvetande
conservative	konservativ
conserve	behålla
consider	betrakta
consolation	tröst
console	trösta
consonant	konsonant
conspiracy	komplott
constant	konstant
construct	bygga
consul	konsul
consulate	konsulat
consult	konsultera
consume	förbruka
contact	kontakt
container	skål
contempt	förakt
contented	belåten
contention	påstående
contents	innehåll
contest	tävling
continent	fastland
continual	konstant
contract	kontrakt
contractor	byggmästare
contradistinction	motsats
contralto	altröst
contralto	altröst
contrary	motsatt
contrast	motsats
control	härska
controller	besiktningsman
control	behärskasig
convention	kongress
conversation	konversation
conversion	ändring
conviction	övertygelse
convince	överbevisa
cook	koka
cool	sval
cooperate	medverka
copper	koppar
copy	exemplar
cord	lina
cordial	hjärtlig
core	kärna
cork	kork
corkscrew	korkskruv
corn	liktorn
corner	hörn
cornflower	blåklint
coronation	kröning
corporal	kroppslig
corporeal	kroppslig
corpse	as
corpulent	diger
correct	korrekt
correspond	korespondera
cost	kosta
costly	dyr
costume	klädedräkt
cotton	vadd
cotton	bomull
couch	kanapé
cough	hosta
counsel	advokat
count	greve
counter	boddisk
countless	otalig
country	landsbygd
countryman	landsbo
countryside	landsbygd
count	addera
couple	äktapar
coupon	kupong
coup	kupé
courage	mandom
courageous	behjärtad
course	kurs
court	gård
courteous	artig
courtyard	gård
cousin	kusin
cover	betäcka
covet	begära
covetousness	begär
cow	ko
crab	krabba
crack	knaka
cradle	födelseort
cramped	smal
crane	kran
crawl	krypa
crayfish	kräfta
craziness	galenskap
crazy	dåraktig
cream	kräm
create	skapa
creature	skapelse
credit	kredit
creep	krypa
crew	besättning
cricket	syrsa
crime	förbrytelse
criminal	brottslig
crisis	kris
criticism	kritik
crocodile	krokodil
crook	niding
cross	arg
crossword	korsord
cross	vägkorsning
crow	kråka
crowd	hop
crucify	korstfästa
crude	nafta
cruel	grym
crush	anlopp
cry	skri
crystal	kristall
cry	hojta
cube	kub
cuckoo	gök
cucumber	gurka
cultivate	avla
culture	kultur
cunning	fiffig
cup	kopp
cupboard	skåp
curate	adjunkt
cure	hela
currant	vinbär
current	ström
currently	nutida
curry	kurry
curse	svära
curtain	förhänge
curve	krok
curved	krokig
cushion	dyna
cuss	svära
custom	tull
custom	vana
customary	bruklig
customer	kund
cut	meja
cutlet	kotlett
cycle	cykel
cyclone	cyklon
cylinder	cylinder
cynical	cynisk
cypres	cypress
czar	tsar
daffodil	narciss
dagger	dolk
daily	alldaglig
daily	dagblad
damage	haveri
dame	dam
dance	bal
dancer	dansös
dandruff	mjäll
danger	fara
dangerous	farlig
dare	töras
darkness	dunkelhet
darling	älskling
data	material
date	dadelpalm
date	dadel
date	dadelpalm
daughter	sonhustru
daughter	dotter
dawn	dagning
day	dag
daybreak	dagning
dazed	oredig
dazzle	blända
dead	avliden
deadly	dödlig
deaf	döv
deaf	dövstum
deal	behandla
dear	ansedd
death	död
debt	skuld
decanter	karaff
deceitful	bedräglig
deceive	bedra
deceiver	bedragare
decide	besluta
declaim	deklamera
declaration	förklaring
declaration	program
declare	betyga
decorate	smycka
decree	dekret
dedicate	ägna
deem	tro
deep	djup
deer	hjort
defeat	nederlag
defence	försvar
defend	försvara
defense	försvar
defiantly	trots
deformed	abnorm
defray	bekosta
degree	grad
delay	anstånd
deliver	avleverera
delivery	leverans
delta	delta
democracy	folkvälde
demolish	slopa
demonstrate	exponera
den	kyffe
dentist	dentist
deny	förneka
depart	gesigiväg
department	fack
dependant	beroende
dependence	beroende
dependent	avhängig
deportment	beteende
deposit	deponera
depository	lada
depressed	deprimerad
depression	kris
depth	djup
derive	härstamma
derrick	kran
describe	beskriva
description	beskrivning
desert	ödemark
deserving	värdig
design	rita
desire	önska
desk	skrivbord
desolate	tröstlös
despair	misströsta
desperate	desperat
despise	förakta
despite	trots
despotic	despotisk
dessert	efterrätt
destroy	förinta
detached	fristående
detached	friståendehus
detail	detalj
detective	detektiv
detention	häkte
determine	befästa
detrimental	ofördelaktig
device	apparat
devil	djävul
devote	ägna
dew	dagg
diabetes	sockersjuka
diagram	figur
dial	platta
dialect	allmogespråk
diamond	diamant
diarrhoea	diarré
diary	diarium
dictate	diktera
dictionary	ordbok
die	avlida
diet	diet
difference	olikhet
different	olik
differently	annorlunda
difficult	mödosam
difficulty	svårighet
dig	gräva
dike	damm
diligent	arbetsam
dimension	omfång
diminutive	liten
din	bråk
diploma	aktstycke
direct	rak
direction	direktion
directions	instruktion
director	direktör
directory	katalog
dirty	smutsig
dis	o‐
disabled	invalid
disadvantage	nackdel
disagreeing	oenig
disagreement	oenighet
disappear	försvinna
disappoint	görabesviken
disappointment	besvikelse
disapprove	missbilliga
disapprove	missbilliga
disc	platta
disciples	anhang
discipline	disciplin
discontent	agg
discontented	missbelåten
discontentedness	agg
discord	oenighet
discount	diskont
discover	upptäcka
discovery	upptäckt
discrete	diskret
discuss	diskutera
disease	sjuka
disgust	vämjelse
dish	fat
disinfect	desinficera
dislike	tyckaillaom
dismal	banal
dismayed	förfärlig
dismiss	avskicka
disobedient	olydig
dispatch	adresskort
display	parad
displeased	missbelåten
displeasure	agg
dispose	avyttra
disposition	begåvning
dissatisfaction	agg
dissatisfied	missbelåten
dissemble	skrymta
dissension	oenighet
dissolve	lösa
distance	avstånd
distil	destillera
distinct	klar
distress	bedröva
distribute	utdela
distribution	utdelning
district	amt
distrust	misstro
dive	dyka
divide	dela
divine	gudomlig
divorce	skilsmässa
divorced	skild
do	göra
dock	syra
doctor	doktor
document	aktstycke
doe	hind
dog	hund
dogma	dogm
doll	docka
domestic	inhemsk
domestic	husdjur
donate	skänka
donkey	åsna
don	detgöringenting
door	dörr
double	dubbel
doubt	tvivla
doubtful	tvivelaktig
dough	deg
dove	duva
down	ned
downstairs	nedan
dowry	hemgift
dozen	dussin
do	handla
drag	dra
dragon	drake
drama	dram
draw	rita
drawer	låda
drawers	underbyxor
drawing	ritning
dreadful	förfärlig
dream	drömma
dreary	förtretlig
dress	klänning
drill	borra
drink	rumla
drink	rumla
drip	droppa
drive	driva
driver	chaufför
drive	förjaga
drive	driva
driving	körkort
dromedary	dromedar
droop	hänga
drop	falla
drown	drukna
drug	läkemedel
drugstore	apotek
drunk	berudsad
drunkenness	dryckenskap
dry	torr
dryness	torka
dual	dubbel
duchess	hertiginna
duchy	hertigdöme
duck	and
duke	hertig
dumb	stum
dumbfounded	förfärlig
duplicate	multiplicera
during	omnatten
dusk	halvdager
dust	damm
dwarf	dvärg
dwell	bo
dwelling	boning
dye	färg
dynamite	dynamit
each	all
each	varandra
eager	begärlig
eagerness	begär
eagle	örn
eagle	uv
ear	öra
earl	greve
early	bittida
earn	förtjäna
earnest	allvarlig
earth	jord
earthquake	jordbävning
east	orient
eastern	orientalisk
easy	lätt
echo	genljuda
economy	ekonomi
ecstasy	extas
edge	brädd
edging	brädd
edible	ätbar
edition	utgift
editor	redaktör
educate	uppfostra
education	uppfostran
eel	ål
effect	effekt
effort	bemödande
egg	ägg
egg	äggtoddy
eight	åtta
eighteen	aderton
eighteenth	adertonde
eighth	åttonde
eighty	åtti
elastic	elastisk
elbow	armbåge
elder	fläder
elect	kora
election	val
electric	elektrisk
electricity	elektricitet
element	element
elemental	elementär
elementary	elementär
elements	alfabet
elephant	elefant
elevator	hiss
eleven	elva
eleventh	elfte
elf	älva
elk	älg
elm	alm
else	annan
elsewhere	annanstans
embankment	damm
emblem	emblem
embrace	famna
emerald	smaragd
emergency	kris
emigrate	utvandra
emissary	sändebud
emmet	myra
emotion	känsla
emperor	kejsare
empire	kejsardöme
employ	engagera
employee	arbetstagare
employer	arbetsgivare
empress	kejsarinna
emptiness	tomhet
empty	tom
enchantment	trolleri
encounter	möta
encyclopaedia	encyklopedi
end	fullborda
ending	slut
endure	lida
end	ankomma
enemy	fiende
energy	energi
engagement	förlovning
engine	lok
engineer	ingenjör
enigma	gåta
enjoy	fröjda
enjoyable	angenäm
enlarge	förstora
enmity	fiendskap
enthusiasm	entusiasm
entice	förföra
entire	hel
entirely	alldeles
entomb	begrava
entrance	inträde
entrust	haförtroendeför
envious	avundsam
envoy	sändebud
envy	avundas
episode	episod
epoch	epok
equal	lik
equally	desslikes
equator	ekvator
equilibrium	balans
era	epok
erect	grunda
err	fela
error	fel
escape	rymma
escort	eskort
establish	grunda
estate	bondgård
esteem	betrakta
estimate	beräkna
ethical	etisk
eunuch	eunuck
evade	kringgå
even	flack
evening	afton
evening	aftonmåltid
event	händelse
ever	någonsin
everlasting	ändlös
every	all
everybody	all
everything	allting
everywhere	allestädes
every	allehanda
every	all
evident	synbarligen
exaggerate	förstora
examination	examen
examine	bepröva
example	exempel
exceed	överstiga
except	utom
except	utöver
excise	accis
excise	accis
exclusively	bara
excuse	urskulda
excuse	förlåt
excuse	beomursäkt
executioner	bödel
exercise	skrivbok
exercise	inöva
exhausted	genomtrött
exhibit	exponera
exhibition	exposition
exhortation	maning
existence	existens
exit	utgång
expect	forvänta
expectation	förväntan
expel	förjaga
expensive	dyr
experiment	försök
expire	sluta
explain	förklara
explanation	explikation
explode	explodera
exposition	exposition
express	uttrycka
expression	uttryck
extend	omfång
extensive	omfångsrik
exterminate	utplåna
extra	extra
extraordinary	synnerlig
eye	öga
eyebrow	ögonbryn
eyelid	ögonlock
fabric	väv
face	anlete
facile	lätt
facilitate	lätta
fact	faktum
faction	part
factory	fabrik
factual	faktisk
faculty	fakultet
fail	klicka
failure	bankrutt
faint	klen
fair	krambod
fairy	saga
faith	förtroende
faithful	lojal
falcon	falk
fall	falla
fall	insjukna
fall	blikäri
false	dolsk
family	familj
famine	hungersnöd
famous	beryktad
fanatical	fanatisk
fancier	amatör
fantasy	fantasi
farewell	adjö
farm	bondgård
farmer	arrendator
farming	jordbruk
farm	förpakta
fashion	mod
fasten	befästa
fast	blixttåg
fat	diger
father	svärfader
father	fader
fatherland	fädernesland
fatherless	faderlös
fault	skuld
favor	befrämja
favour	befrämja
favourable	blid
fa	fasad
fear	fruktan
feather	fjäder
fee	honorar
feeding	nappflaska
feign	låtsassomom
fellow	karl
felt	filt
female	kvinnlig
female	kokerska
female	hårfrisörska
female	arbeterska
female	sångerska
female	lärarinna
femal	arbeterska
femal	arbeterska
feminine	kvinnlig
fence	bom
fence	hägna
ferry	färja
fertile	fruktbar
fertilizer	dynga
festival	fest
fetch	avhämta
fever	feber
fianc	fästman
fianc	fästmö
fiber	fiber
fibre	fiber
fief	län
field	åker
field	ambulansbil
fifteen	femton
fifteenth	femtonde
fifth	femte
fifty	femti
fig	fikon
fight	kämpa
figure	figur
file	fila
files	arkiv
fill	fylla
filling	bensinstation
fill	fylla
fill	fylla
filter	filtrera
filthy	smutsig
fin	fena
final	ändlig
financial	finansiell
find	finna
find	befinnasig
fine	skön
finger	finger
finish	fullborda
finished	färdig
fir	gran
fire	eld
firewood	ved
firing	kapsyl
firm	affärshus
first	första
first	förnamn
fish	fiska
fisherman	fiskare
fishing	metspö
fist	näve
fit	harmoniera
five	fem
fix	befästa
fixed	stadig
fix	arrangera
fjord	fjord
flag	flagg
flame	flamma
flannel	flanell
flat	strykjärn
flat	lägenhet
flatter	lisma
flattery	smicker
flax	lin
flea	loppa
flee	rymma
fleet	flotta
flesh	kött
flexible	smidig
flight	flykt
fling	svinga
flint	kisel
float	flyta
flood	flod
floor	våning
flour	mjöl
flow	rinna
flower	blomma
fluent	flytande
flute	flöjt
fly	flyga
foam	fradga
fog	dimma
fold	vecka
folder	skrivbok
foliage	löv
folk	folk
follow	följa
following	anhang
fondle	smeka
food	mat
fool	narr
foolish	befängd
foot	fot
for	för
force	förplikta
forecast	varsla
forehead	panna
foreign	främmande
foreigner	främmande
foreign	utland
forest	skog
foretell	varsla
forge	smida
forget	förgätmigej
forget	glömma
forgetful	glömsk
forgive	benåda
fork	gaffel
form	bilda
formal	ceremoniell
formidable	synnerlig
formula	formel
forsake	lämna
fortunate	lycklig
forty	fyrti
for	länge
for	tillexempel
for	tillexempel
for	tilluthyrning
for	på
for	tillsalu
foul	oväder
found	grunda
foundation	botten
fountain	fontän
four	fyra
fourteen	fjorton
fourteenth	fjortonde
fourth	fjärde
fowl	höna
fox	mickel
fragile	brytbar
free	fristående
free	avgiftsfri
freedom	frihet
freemason	frimurare
freeze	frysa
freezing	frost
frequently	ofta
fresh	sötvatten
friend	väninna
friendly	snäll
friendship	vänskap
frieze	fris
fright	fruktan
frindge	frans
fringe	brädd
frog	groda
from	av
from	varifrån
frontier	gräns
frost	frost
froth	fradga
fruit	fruktträd
fruit	frukt
fuel	brännmaterial
full	myndig
full	full
full	avbetalning
fun	fröjd
function	ämbete
fund	fond
funeral	begravning
fungus	svamp
funnel	tratt
funny	komisk
fur	päls
furious	rasande
furnace	kamin
furnish	avleverera
furnished	möblerad
furniture	bohag
furniture	flyttbil
future	tillkommande
fuzzy	dimmig
gadfly	broms
gag	fars
gain	förvärv
gall	galla
gallery	galleri
gallop	fyrsprång
galosh	galosch
game	lek
gang	band
gaol	fängelse
gape	gapa
garden	trädgård
gardener	trädgårdsmästare
garland	girland
garlic	vitlök
garrison	garnison
gas	gas
gasolene	bensin
gasoline	bensin
gate	port
gateway	port
gather	församla
gathering	församling
gaunt	smal
gawk	gapa
gay	glad
gaze	stirra
gazelle	gasell
gem	juvel
general	general
generality	allmänhet
generally	iallmänhet
generative	sexuell
generous	givmild
gentle	söt
gentleman	herre
genuinly	sannerligen
geography	geografi
geological	geologisk
geometry	geometri
gesture	gest
get	förvärva
get	skiljas
get	skiljas
get	giftasig
get	mögla
get	tröttna
ghastly	förtretlig
gherkin	gurka
ghost	gast
giant	jätte
gift	gåva
gigantic	jättelik
gill	gäl
gin	genever
ginger	ingefära
giraffe	giraff
girder	balk
girdle	bälte
girl	flicka
give	skänka
give	rapportera
give	cedere
give	anmäla
give	dofta
give	bedröva
give	föranleda
give	cedere
give	cedere
glad	glad
gladness	fröjd
glass	glas
glasses	glasögon
glaze	glasyr
glide	glida
globe	glob
glove	handske
glow	glöda
glow	glöda
glue	lim
gnat	mygga
gnaw	gnaga
go	gå
goat	get
goblet	bägare
god	gud
gold	guldgruva
gold	guld
goldfish	guldfisk
goldsmith	guldsmed
good	avsked
good	godhjärtad
good	snäll
good	bra
goodbye	adjö
goodness	godhet
good	goddag
good	goddag
good	godafton
good	gutår
good	godmorgon
goose	gås
gooseberry	krusbär
gossip	prata
gout	gikt
govern	härska
government	regering
gown	klänning
go	gesigiväg
go	görakonkurs
go	promenera
go	uppleva
go	dala
grade	grad
grain	korn
gram	gram
grammar	grammatik
gramme	gram
grandchild	barnbarn
granddaughter	dotterdotter
grandfather	farfar
grandmother	farmor
grandparents	farföräldrar
grandson	dotterson
granite	granit
grant	medge
granule	korn
grape	druva
grapevine	vinstock
grapple	fånga
grass	gräs
grasshopper	gräshoppa
gratitude	tack
grave	graf
gravel	kisel
graveyard	kyrkogård
gravy	spad
grease	fett
great	stor
greediness	begär
greedy	begärlig
green	grön
greenweed	ginst
greet	hälsa
greeting	hälsning
grenade	granat
grey	grå
grief	bedrövelse
grisly	förtretlig
groan	ajasig
grocer	specerihandlare
grotto	grotta
ground	bottenvåning
ground	botten
grounds	terräng
group	flock
grow	bli
grown	myndig
grow	surna
grub	gräva
grudge	agg
gruesome	förfärlig
gruff	ovänlig
guarantee	garantera
guard	vakta
guess	gissa
guest	gäst
guide	vägledare
guidebook	gid
guilt	skuld
guiltless	oskyldig
guilty	skyldig
guitar	gitarr
gulf	avgrund
gum	tandkött
gun	gevär
gunpowder	krut
gymnastics	gymnastik
gypsy	tattare
habit	vana
hack	hugga
hail	hagel
hair	hår
hairdresser	hårfrisörska
hairpiece	peruk
half	halv
hall	hall
ham	skinka
hammer	hamra
hand	handväska
hand	arbetare
handbook	gid
handle	behandla
handlebars	styre
handsome	skön
hang	hänga
hangman	bödel
hang	behålla
happen	bli
happiness	lycka
happy	lycklig
harbor	hamn
harbour	hamn
hard	hård
hardly	knappast
hardworking	arbetsam
hare	hare
harem	harem
harmful	menlig
harmonica	harmonika
harmonize	harmoniera
harmony	harmoni
harp	harpa
harrier	kyrka
harrow	harva
harsh	ovänlig
harvest	hösta
haste	hast
hat	hatt
hate	hata
haul	dra
have	ha
have	haotur
have	hamedlidande
have	haförtroendeför
have	mätta
have	haförtroendeför
have	haförtroendeför
have	hatur
have	ha
have	böra
hawk	hök
hay	hö
hazard	slump
hazel	hassel
hazel	hassel
hazelnut	hasselnöt
he	bock
he	han
head	huvud
headache	huvudvärk
header	rubrik
heading	titel
heal	hela
health	hälsa
healthy	sund
heap	hop
hear	höra
heart	hjärtlig
heart	hjärta
hearty	hjärtlig
heat	glöd
heath	hed
heaven	himmel
heavenly	himmelsk
heavenly	himlakropp
heavy	tung
hectolitre	hektoliter
hedge	häck
heel	häl
height	höjd
heighten	försämra
heir	arvinge
hell	helvete
hello	hej
helm	styre
helmet	hjälm
help	biträda
helper	hjälpare
helpful	behjälplig
helpless	hjälplös
hemisphere	halvklot
hemp	hampa
her	sin
herb	gräs
herd	flock
here	hit
hereditary	ärftlig
heresy	kätteri
heretic	kättare
hero	hjälte
heroic	hjältemodig
heroin	hjältinna
heroine	hjältinna
heron	häger
herring	sill
herself	själv
hesitate	tveka
hesitation	tvekan
hiccup	hicka
hidden	dold
hide	päls
hideous	gruvlig
high	gymnasium
high	flod
hill	backe
him	han
himself	själv
hind	hind
hinge	gångjärn
hinny	mulåsna
hint	alludera
hip	höft
hippo	flodhäst
hippopotamus	flodhäst
hire	engagera
his	hans
history	historia
hit	banka
hither	hit
hoarse	hes
hock	rensktvin
hoe	skyffel
hog	gris
hold	behålla
hole	glugg
holy	helig
home	hem
homy	hemtrevlig
honest	redlig
honey	honung
honor	hedra
honorary	hederlig
honour	hedra
hoof	hov
hook	häkta
hooker	hora
hooter	horn
hope	hoppas
horizon	horisont
horizontal	horisontal
horn	horn
horrible	förtretlig
horse	kastanje
horse	broms
horse	pepparrot
horse	häst
horsepower	hästkraft
horseradish	pepparrot
horseshoe	hovjärn
hospitable	gästfri
hospital	sjukhem
hospitality	gästvänskap
host	värd
hostage	gisslan
hostel	gästgivargård
hostess	värdinna
hostile	fientlig
hot	het
hotel	hotell
hour	timme
house	husägare
house	hus
housefly	fluga
house	kyrka
hovel	kyffe
hover	sväva
how	hur
however	likafullt
howl	råma
how	hurmycket
how	hurmycket
hug	krama
huge	jättelik
hull	kasko
hum	surra
human	mänsklig
human	människa
human	mänsklighet
humor	humor
humour	humör
humourous	humoristisk
hump	puckel
hundred	hundra
hunger	hunger
hungry	hungrig
hunt	jaga
hunter	jägare
hurray	hurra
hurricane	orkan
hurried	hastig
hurt	smärta
husband	make
husk	bark
hut	hydda
hyaena	hyena
hydrogen	vätebomb
hygiene	hygien
hygienic	hygienisk
hymn	hymn
hypnosis	hypnos
hypnotic	hypnos
hypnotist	hypnotisör
hypnotize	hypnotisera
hypothesis	hypotes
hypothetical	hypotetisk
hysteria	hysteri
hysterical	hysterisk
ice	glass
iceberg	isberg
icecream	glass
idea	idé
ideal	ideal
identical	identisk
idiot	fåne
idol	avgud
if	om
il	o‐
ill	dålig
illness	sjuka
illuminate	belysa
illusion	illusion
illustrate	illustrera
im	o‐
image	bild
imitate	efterbilda
immaterial	likgiltig
immensely	stenrik
immigrate	invandra
impartial	neutral
impatient	otålig
impel	driva
impertinent	fräck
imply	beteckna
important	viktig
impossible	omöjlig
imposter	bedragare
improve	bättra
in	o‐
in	i
incense	rökelse
inch	tum
inconceivable	obegriplig
inconvenient	mödosam
incorrect	oriktig
increase	förstora
incredible	otrolig
incubate	häcka
indeed	ju
independant	oberoende
index	tabell
indicate	utpeka
indication	varsel
indifferent	likgiltig
indignant	harmlig
indistinct	oklar
individual	individuell
industrial	industriell
industrious	arbetsam
industry	industri
inebriety	dryckenskap
inexpensive	billig
inexplicable	oförklarlig
infant	barn
infantry	fotfolk
infection	infektion
inference	konklusion
infertile	ofruktbar
influence	påverka
inform	tillkännagiva
inhabitant	inbyggare
inherit	ärva
inheritance	arv
inhibit	förhindra
initial	initialbokstav
injury	sår
ink	bläckhorn
ink	bläck
inkpot	bläckhorn
inlet	fjord
inn	gästgivargård
innkeeper	värd
innocence	oskuld
innocent	oskyldig
inquiry	rundfråga
inquisitive	frågvis
insane	dåraktig
insane	hospital
insanity	galenskap
insatiable	omättlig
insect	insekt
inside	i
inspect	besiktiga
inspection	inspektion
inspector	besiktningsman
install	inreda
instant	momang
instinct	instinkt
instruction	instruktion
instructor	lektor
instrument	instrument
insubordinate	olydig
insult	skällaut
insurance	assurans
insure	försäkra
inter	begrava
intercessor	advokat
interest	intresse
interesting	intressant
interment	begravning
intermission	paus
international	internationell
interpret	tolka
interpreter	tolk
interrupt	avbryta
interval	intervall
interview	intervjua
intestine	tarm
intestines	inälvor
intimate	intim
into	i
intolerant	intolerant
intoxicated	berudsad
introduce	presentera
invective	skällsord
invention	uppfinning
inverted	anföringstecken
investigation	examen
invincible	oövervinnelig
invitation	bjudning
invite	bjuda
invoice	faktura
invoke	anropa
inwards	in
in	aktiv
in	emot
in	förrän
in	ingalunda
in	för
in	trots
in	omaftarna
in	ommorgonen
in	förgäves
in	hur
iron	järn‐
island	ö
itch	klia
its	sin
itself	själv
it	detgöringenting
ivory	elfenben
ivy	murgröna
jack	billyftare
jackal	schakal
jacket	jacka
jail	fängelse
jam	marmelad
jaw	käft
jawbone	käft
jaws	gap
jay	skrika
jealous	jalu
jealousy	jalusi
jeer	håna
jelly	manet
jenny	åsninna
jerk	rycka
jest	skoja
jewel	juvel
jeweller	juvelerare
job	arbete
join	ansluta
joint	gemensam
joke	skoja
journal	dagblad
journalist	journalist
journey	färd
joy	fröjd
judge	döma
judgment	dom
jug	kruka
juice	saft
jumbled	konfys
jump	hoppa
june	majbagge
just	riktig
justice	rätt
just	just
kangaroo	känguru
keel	köl
keen	livaktig
keep	vakta
keeper	arkivarie
kernel	kärna
kettle	kokare
key	nyckel
kick	sparka
kidney	njure
kill	avliva
kiln	kamin
kilo	kilogram
kilometre	kilometer
kind	snäll
kindle	antända
king	dam
kingdom	konungarike
kirk	kyrka
kiss	kyssa
kitchen	kök
kite	kyrka
klaxon	horn
knapsack	ryggsäck
knead	knåda
knee	knä
knife	kniv
knight	riddare
knock	knacka
knot	knut
know	känna
knowledge	kunskap
know	veta
laboratory	laboratorium
laborer	arbetare
labourer	arbetare
lace	pund
lack	brist
lad	gosse
ladder	stege
laddie	gosse
ladies	herrskap
lady	dam
lake	insjö
lamb	lamm
lame	lam
lamp	lampa
lance	lans
land	land
landlady	värdinna
landlord	värd
landscape	landskap
landslide	skred
lane	gränd
language	språk
larch	lärkträd
large	stor
lark	lärka
larva	larv
lass	flicka
last	siska
lasting	oupphörlig
last	iafse
laud	berömma
laugh	skratta
laughter	skratt
laundress	tvätterska
lava	lava
law	lag
lawn	gräsmatta
lawsuit	rättegång
lawyer	advokat
laxative	laxativ
lay	lägga
layman	lekman
lay	lägga
lay	fatta
lazy	lat
lead	föra
leader	anförare
leaf	blad
leaflet	broschyr
lean	stödja
leap	skottår
leap	hoppa
learn	lära
lease	hyreskontrakt
leather	läder
leave	gesigiväg
lector	lektor
lecturer	lektor
leech	blodigel
leek	vitlök
left	vänster
leg	ben
legal	rättslig
legation	legation
legend	legend
legible	läslig
legitimize	legitimera
lemon	citron
lemonade	limonad
lend	låna
length	längd
lengthen	förlänga
lens	lins
lentil	lins
lesson	lektion
let	uthyra
letter	brev
letterbox	brevlåda
lettuce	salad
let	tillkännagiva
level	flack
lever	hissa
lewd	okysk
liberal	liberal
librarian	bibliotekarie
library	bibliotek
lie	ligga
lieutenant	löjtnant
life	livbåt
life	levnad
lift	hissa
light	antända
lighthouse	fyr
lighting	belysning
lightning	blixt
like	hur
likely	antaglig
likewise	också
like	sålunda
lilac	syren
lily	konvalje
lily	lilja
limb	lem
lime	lind
lime	kalk
limit	avgränsa
limp	halta
linden	lind
line	linje
lineage	tillkomst
link	montera
lion	lejon
lip	läpp
liqueur	likör
liquid	vätska
liquidate	avliva
lira	lyra
listen	höra
listener	hörare
liter	liter
literature	litteratur
litre	liter
little	liten
live	bo
lively	spirituell
liver	lever
liver	leverkorv
live	hyraettrum
live	boihop
live	uppleva
living	ensamstående
lizard	ödla
load	ladda
loaf	bröd
loan	låna
loathe	avsky
lobster	hummer
local	lokal
location	ort
loch	fjord
lock	lås
locust	gräshoppa
logic	logik
long	lång
longing	begär
longitude	longitud
long	längtaefter
look	anblick
looking	spegel
look	vakta
look	beskåda
look	leta
lord	herre
lorry	lastbil
lose	förlora
loss	förlust
lottery	lotteri
loud	ljudelig
lounge	salong
louse	lus
love	älska
lovely	angenäm
lover	älskarinna
low	låg
low	ebb
loyal	lojal
luck	tur
luggage	bagagevagn
luggage	bagage
lukewarm	ljum
lump	bit
lunacy	galenskap
lunatic	dåre
lung	lunga
lupine	lupin
lust	passion
luxury	lyx
lyceum	lyceum
lying	barnsängskvinna
lynx	lo
lyre	lyra
lyric	text
machine	maskin
mackerel	makrill
mad	dåraktig
madam	fru
madness	galenskap
magazine	magasin
magic	trolleri
magical	magisk
magnet	magnet
magnetic	magnetisk
magpie	skata
maid	städerska
mail	post
mailbox	brevlåda
mailman	posttjänsteman
mainland	fastland
maintain	behålla
maize	majs
major	major
major	huvudled
make	smink
make	göra
make	görabekantskapmed
make	fela
make	bullra
make	annotera
make	luttra
make	befästa
make	håna
make	smink
make	nyttja
make	kriga
male	manlig
male	kock
malt	malt
mam	mamma
mammy	mamma
man	människa
manage	förvalta
manager	administratör
maneuver	manöver
mankind	mänsklighet
manner	maner
manoeuvre	manöver
mantle	kappa
manure	dynga
many	många
man	manöver
map	karta
maple	lönn
marble	marmor
march	gå
margarine	margarin
mark	märke
market	krambod
marketplace	marknad
marmelade	marmelad
marriage	äktenskap
married	gift
married	äktapar
marry	giftasig
marsh	kärr
marten	mård
martial	krigisk
martyr	martyr
marvel	förvånasig
marvel	förvånasig
masculine	manlig
mask	mask
mason	murare
mass	hop
massive	massiv
mast	mast
master	mästare
master	byggmästare
match	sticka
material	materiell
maternal	moster
maternal	morfar
maternal	mormor
maternal	morföräldrar
maternal	morbroder
mathematics	matematik
matter	affär
mattress	madrass
mature	mogen
maximum	maxiumum
maybe	kanhände
mayhap	kanhände
mayor	borgmästare
meadow	äng
meal	mjöl
mealies	majs
mean	beteckna
meaning	bemärkelsedag
means	instrument
measles	mässling
measured	ceremoniell
medal	medalj
medicine	läkemedel
meet	mötas
meeting	möte
mellowness	vekhet
melody	låt
melon	melon
melt	smälta
melting	töväder
member	lem
memory	minne
menace	hota
mend	flicka
mental	andlig
menu	karta
merchandise	vara
merchant	affärsman
mercury	kvicksilver
merry	glad
message	bekantgörande
messenger	sändebud
metal	metall
metalled	sten‐
method	metod
metre	meter
metropolis	världsstad
microscope	mikroskop
midget	dvärg
midwife	ackuschörska
mild	blid
mile	mil
milk	mjölk
miller	mjölnare
million	miljon
mind	ande
mine	gruva
miner	gruvarbetare
mineral	mineral
mingle	blanda
minister	departementschef
ministry	ministär
minority	mindretal
mint	mynta
minute	minut
miracle	under
miraculous	underbar
mirror	spegel
miscarriage	abort
miscarry	klicka
miscellaneous	varjehanda
miser	gnidare
miserable	arg
miserly	girig
miss	missa
mist	dimma
mistake	fel
mistress	mästarinna
misty	dimmig
misunderstanding	missförstånd
mitten	handske
mix	blanda
mixture	röra
moan	stöna
mock	håna
mockery	hån
mode	maner
model	modell
modern	modern
modest	blygsam
moist	fuktig
mold	mögel
mole	mullvad
molecule	molekyl
mom	mamma
moment	momang
mommy	mamma
monastery	kloster
money	kassa
money	mynt
money	kassa
monk	munk
monkey	apa
monopoly	monopol
monotonous	entonig
monster	monster
month	månad
monument	minnesmärke
mood	mod
moon	måne
moor	stepp
moorage	redd
mooring	redd
moose	älg
moped	moped
more	mer
morning	morgon
morphia	morfin
morphine	morfin
mortgage	gravitation
mosque	moské
moss	lav
most	mest
moth	nattfjäril
mother	svärmor
mother	moder
motive	motiv
motor	motor
motorcycle	motorcykel
motorist	bilist
motto	devis
mould	mögel
mount	montera
mountain	rönnbär
mountain	berg
mountain	berg
mourning	likfärd
mouse	mus
mousetrap	råttfälla
moustache	mustasch
mouth	gap
move	flytta
movie	biograf
mow	meja
mucus	slem
mud	dy
mule	mula
multiply	multiplicera
multitude	hop
mummy	mumie
munition	ammunition
murder	mörda
murderer	dråpare
murk	dunkelhet
muscle	muskel
muse	musa
museum	museum
mushroom	svamp
music	musik
musical	musikalisk
musician	musikant
mussel	mussla
must	böra
mustard	senap
mute	stum
mutton	fårkött
muzzle	gap
my	min
mysterious	mysteriös
mystery	mysterium
mystic	mystisk
mystical	mystisk
myth	myt
nail	nagelborste
nail	spika
naked	bar
name	namn
nameless	anonym
namely	nämligen
nape	nacke
napkin	servett
narcissus	narciss
narrate	berätta
narrative	berättelse
narrow	smal
nasturtium	krasse
nasty	förtretlig
nation	nation
national	nationell
nationality	nationalitet
native	infödd
natural	naturlig
natural	naturgas
nature	art
naught	nolla
nausea	vämjelse
navy	marin
na	naiv
na	naiv
near	kortsynt
near	bi
nearby	bi
nearly	nästan
nearness	närhet
near	bi
necessary	behövlig
neck	hals
necklace	halsband
need	behöva
needle	nål
negative	negativ
negligent	oaktsam
negotiate	handla
neigh	gnägga
neighbour	granne
neighbourhood	kvarter
neither	ingen
neither	varken...eller
nephew	brorson
nerve	nerv
nervous	nervös
nest	kyffe
net	nät
nettle	brännässla
network	nät
neutral	neutral
never	aldrig
nevertheless	likafullt
never	detgöringenting
new	ny
newspaper	dagblad
next	kommande
next	närmaste
next	bi
nice	angenäm
niche	nisch
nickel	nickel
nickname	binamn
niece	brorsdotter
niggard	gnidare
night	natt
nightingale	näktergal
nightmare	mara
night	aftonbön
nine	nie
nineteen	nitton
nineteenth	nittonde
ninety	nitti
ninth	nionde
nipple	spene
nitrogen	kväve
no	ingen
no	nej
nobility	adel
noble	ädel
nobleman	jarl
nobody	ingen
node	knut
noise	bråk
non	frånvaro
non	underofficer
noncom	underofficer
none	ingen
normal	normal
north	norrut
northern	nordlig
northward	norrut
northwards	norrut
nose	näsa
nostril	näsborr
not	ej
note	biljett
notebook	skrivbok
noteworthy	anmärkningsvärd
nothing	ingenting
notice	anslagstavia
notice	affisch
notion	begrepp
notwithstanding	trots
not	ingalunda
not	ingalunda
nought	noll
noun	substantiv
novel	ny
now	nå
nowadays	nutida
nowhere	ingenstans
nucleus	kärna
nude	bar
null	nolla
number	husnummer
numberplate	nummerplåt
number	husnummer
numeral	nummer
nun	nunna
nurse	ansa
nursery	lekskola
nut	nöt
nuts	dåraktig
nymph	nymf
oak	ek
oar	åra
oasis	oas
oath	ed
oats	havre
obedient	hörsam
obey	hörsamma
object	objekt
obscure	obskur
observe	observera
obstacle	hinder
obstetrician	ackuschörska
obtain	förvärva
obvious	synbarligen
occasion	gång
occur	hända
occurence	händelse
ocean	ocean
oculist	ögonläkare
odd	egendomlig
odor	doft
odour	doft
of	av
offence	anstöt
offend	skällaut
offensive	offensiv
offer	offert
office	byrå
officer	officer
official	officiell
offset	avstånd
offspring	telning
often	ofta
of	varjehanda
of	ökländ
of	adlig
of	sandig
of	avsiden
of	kroppslig
of	solig
of	vinterlig
of	vars
oh	ack
oil	olja
okay	bra
old	gammaldags
old	gammal
olive	oliv
omelette	omelett
omen	varsel
omnibus	omnibus
omnipotence	allmakt
omnipotent	allrådande
omniscient	allvetande
on	i
once	åter
one	någon
onerous	tung
one	varandra
one	hundra
one	tusen
onion	lök
only	bara
only	knappast
on	på
on	infall
on	ackurat
on	uppe
opal	opal
open	stänga
open	stänga
opera	opera
operate	operera
operation	operation
operative	arbetare
ophtalmologist	ögonläkare
opine	anse
opinion	mening
opponent	vedersakare
opportunity	händelse
opposed	emot
opposite	emot
opposition	motsats
oppress	trycka
optician	optiker
optimism	optimism
option	alternativ
oracle	orakel
orange	apelsin
orchestra	orkester
order	befalla
ordinarily	gemenligen
ore	malm
organ	organ
organization	organisation
original	original
originate	härstamma
ornament	smycka
orthodox	renlärig
ostrich	struts
other	annan
other	utom
ought	böra
our	vår
out	ute
outfit	klädedräkt
outline	silhuett
outside	ute
outskirts	periferi
out	från
out	gammaldags
out	kaputt
oval	oval
oven	kamin
overall	total
overcoat	paletå
overhead	uppe
overpower	ockupera
overshoe	galosch
over	där
ow	ack
owing	på
owl	uggla
own	innehava
owner	ägare
ox	oxe
oxygen	syre
oyster	ostron
o	timme
pace	steg
pack	packa
packet	paket
pad	block
pagan	hednisk
pail	bytta
pain	pina
painful	pinsam
paint	färga
painter	målare
painting	målning
pair	duo
pal	kamrat
palace	palats
pale	glåmig
palm	palm
palmtree	palm
pamper	kela
pamphlet	broschyr
panic	panik
pantechnicon	flyttbil
pantechnicon	flyttbil
panties	underbyxor
pantomime	pantomim
pants	benkläder
paper	tapetserare
paper	dokument
paperback	broschyr
paperer	tapetserare
parachute	fallskärm
parade	parad
paradise	paradis
paraffin	fotogen
paraffin	paraffin
paragraph	paragraf
parallel	parallel
paralyse	förlama
parapet	balustrad
parasite	parasit
parcel	paket
pardon	benåda
parenthesis	spasm
parents	svärföräldrar
parents	föräldrar
parish	prästgård
park	park
parliament	parlament
parlour	salong
parrot	papegoja
parsley	persilja
part	andel
partial	partisk
particular	särskild
partridge	rapphöna
party	anhang
passable	gångbar
passenger	passagerare
passion	glöd
passionate	passionerad
passport	pass
pass	avlida
paste	deg
pastor	präst
patch	flicka
patch	flicka
pate	huvud
patent	oktroj
paternal	faster
paternal	farfader
paternal	farmor
paternal	farföräldrar
paternal	farbroder
path	bana
patience	tålamod
patient	tålig
patriarch	patriark
patrol	patrull
patron	beskyddare
pattern	schema
pause	paus
pavement	gångbana
pavilion	paviljong
paw	ben
pawn	pion
pay	betala
payment	avbetalning
pay	beakta
pay	beakta
pay	avbetala
pay	bekosta
pea	ärt
peace	fred
peach	persika
peacock	påfågel
pear	päron
pearl	pärla
peasant	landsbo
peculiar	egendomlig
pedal	pedal
pedestrian	fotgängare
peel	bark
peer	stirra
pelican	pelikan
pelvis	skål
pen	fickkniv
pencil	blyertspenna
peninsula	halvö
pension	pension
people	folk
pepper	peppar
per	i
percent	procent
percentage	procent
perchance	kanhände
perform	göra
perfume	parfym
perhaps	kanhände
peril	fara
period	period
periodical	tidskrift
periphery	periferi
perish	förgås
permanent	konstant
perplexed	oredig
persecute	förfölja
persecution	förföljande
person	person
personal	personlig
personality	art
personal	personnummer
perspiration	svett
persuade	överbevisa
pessimistic	pessimistisk
pestilence	pest
pet	kela
petrol	bensin
petroleum	fotogen
phantom	gast
pharmaceutical	läkemedel
pheasant	fasan
phenomenon	fenomen
philosopher	filosof
phlegm	slem
phone	telefonhytt
phosphorus	fosfor
photograph	fotografera
photographer	fotograf
photography	fotografi
physical	kroppslig
physician	doktor
physics	fysik
piano	piano
pick	sticka
pick	kora
pick	avhämta
picture	bild
picture	vykort
pie	tårta
piece	andel
piece	möbel
pig	gris
pigeon	duva
pigeonhole	fack
pigmy	dvärg
pike	gädda
pile	hop
pilgrimage	pilgrim
pill	piller
pillar	pelare
pillow	huvudgärd
pilot	lotsa
pin	knappnål
pine	fur
pine	fur
pineapple	ananas
pink	nejlika
pioneer	pionär
pious	gudlig
pip	korn
pipe	pipa
pirate	pirat
pistol	pistol
pit	kärna
pitcher	kruka
pitch	becksvart
pity	hamedlidande
pivot	spindel
placard	affischera
place	ort
place	födelseort
place	kyrka
plague	pest
plaice	rödspotta
plain	slätt
plan	projekt
plane	platan
plane	flygmaskin
planet	planet
plank	bräde
plant	plantera
plate	fat
platform	kaj
platinum	platina
platter	fat
plausible	trolig
play	leka
plaza	torg
pleasant	angenäm
please	varsågod
pleased	belåten
pleasure	behag
plot	intrig
plough	plöja
pluck	plocka
plug	gnista
plug	ansluta
plum	plommen
plume	plym
plunder	roffa
plunge	dyka
pocket	ficka
poem	dikt
poet	diktare
poetry	poesi
point	uppvisa
poison	förgifta
poisonous	ettrig
pole	grav
police	polisstation
police	polis
policeman	konstapel
policy	politik
polish	glansslipa
polite	artig
politeness	artighet
political	politisk
politician	politiker
politics	politik
polyp	polyp
pond	damm
pool	para
poor	arg
pope	påve
poplar	poppel
poppy	vallmo
popular	populär
population	befolkning
porch	partvalv
porcupine	piggsvin
pork	fläsk
port	hamn
portable	portativ
portal	inträde
portent	varsel
porter	dörvakt
portfolio	portfölj
port	babord
position	position
possess	innehava
possession	egendom
possible	möjlig
possibly	kanhände
post	portofri
post	affischera
postage	porto
postage	frimärke
postal	postnummer
postcard	brevkort
poster	affisch
postman	brevbärare
post	postkontor
post	affischera
pot	kanna
potato	potatis
pound	pund
pour	gjuta
poverty	armod
powder	pulver
powerful	mäktig
practicable	gångbar
practical	praktisk
practice	övning
practise	inöva
praise	berömma
prawn	räkna
pray	bedja
prayer	bön
preach	predika
preacher	predikant
precipice	avgrund
precise	ackurat
precursor	varsel
preferably	hellre
pregnant	havande
prejudice	fördom
preparation	beredelse
prepare	bereda
presage	varsel
prescription	recept
presence	närvaro
present	gåva
present	presentera
preservative	preventivmedel
preserve	behålla
president	president
press	trycka
pressure	tryck
presume	anta
pretend	låtsassomom
pretext	förevändning
prevent	förhindra
prey	fångst
price	pris
pricey	dyr
pride	stolthet
primeval	urskog
primitive	primitiv
primrose	viva
prince	furste
princess	furstinna
principality	furstendöme
principle	princip
print	trycka
prison	fängelse
privilege	privilegium
probable	antaglig
probably	troligtvis
problem	problem
procedure	förfäringssätt
proceed	processa
process	förfäringssätt
procession	procession
proclamation	förklaring
produce	alstra
product	alster
production	alstring
profess	bekänna
profession	profession
professor	professor
profile	profil
profit	profitera
profound	djup
programme	program
project	projekt
proletarian	proletär
promise	lova
prompt	ackurat
proof	bevis
prop	stöd
propaganda	propagando
property	bondgård
prophesy	varsla
prophet	profet
prose	prosa
prosecute	förfölja
protect	beskydda
protection	beskydd
protest	protest
prototype	urbild
prot	skyddsling
prot	skyddsling
proud	stolt
prove	bevisa
proverb	ordspråk
provided	om
province	landskap
provincial	provinsiell
proximity	närhet
psalm	psalm
pseudonym	pseudonym
psyche	psyke
psychiatrist	psykiater
psychiatry	psykiatri
psychic	psykisk
public	allmän
publicity	propagando
public	torg
publish	offentliggöra
publisher	förläggare
pudding	pudding
pull	rycka
pull	slopa
pulpit	kateder
pulsate	pulsera
pulse	puls
pump	pumpa
punctual	ackurat
punish	aga
punishment	straff
puppet	docka
purchase	anskaffa
purchaser	köpare
purchase	köpesumma
pure	gedigen
purge	luttra
purple	purpur
purse	börs
pursue	förfölja
pursuit	förföljande
push	puffa
put	lägga
putty	kitt
put	lägga
put	inreda
put	presentera
put	förfärlig
put	lida
puzzle	gåta
puzzle	grubbla
pyjamas	pyjamas
pyramid	pyramid
quadrangle	fyrhörning
quality	egenskap
quarrel	gräla
quarter	kvarter
quarter	kvart
quash	förinta
quay	kaj
queen	dam
question	fråga
quicksilver	kvicksilver
quit	lämna
quite	bra
quiver	bäva
quotation	anförande
quotation	anföringstecken
quote	anföra
rabbi	rabbin
rabbit	kanin
rabies	rabies
raccoon	sjubb
race	springa
rack	grubbla
racoon	sjubb
radiate	stråla
radio	radio
radish	rädisa
raffle	lotteri
raft	flotte
rag	lapp
ragout	ragu
railing	balustrad
railroad	järnväg
railway	järnväg
rain	regna
rainbow	regnbåge
raincoat	regnrock
raise	uppfostra
raise	alarmere
rake	kratta
ram	bagge
ranch	bondgård
rancour	agg
rand	brädd
rank	rang
rapier	värja
rare	rar
raspberry	hallon
rat	råtta
rate	rang
rather	någorlunda
ravine	bergklyfta
raw	okokt
ray	stråle
razor	rakblad
razor	rakkniv
reach	ernå
reaction	reaktion
reactionary	reaktionär
read	läsa
reading	lektyr
ready	färdig
real	faktisk
reality	sanning
realization	begrepp
realize	begripa
really	sannerligen
rear	baklykta
rear	baklykta
reason	orsak
rebel	rebell
rebound	studsa
rebuke	missbilliga
recall	ihågkomma
receipt	betalningsbevis
receive	tackajatill
recess	paus
recipe	recept
recite	deklamera
recline	ligga
recognize	erkänna
recollect	ihågkomma
recollection	minne
recommend	anbefalla
recommendable	rekommendabel
recommendation	anbefallning
record	platta
records	arkiv
recover	hela
recovery	räddning
recruit	rekryt
rector	rektor
red	röd
reek	osa
reflect	begrunda
refusal	vägran
refuse	neka
regal	furstlig
regard	betrakta
regiment	regemente
region	gebit
register	inregistrera
regret	ångra
regrettable	beklaglig
regrettably	detvarsynd
regular	regelmässig
regularly	ofta
regulations	reglemente
reindeer	ackja
reindeer	ackja
reject	tackanejtill
rejoice	fröjda
relate	berätta
related	anhörig
relation	förhållande
relations	släkt
relationship	släkt
relative	anförvant
relatives	släkt
release	befria
reliable	pålitlig
relief	lättnad
relieved	lättad
religion	religion
religious	religiös
relinquish	cedere
rely	haförtroendeför
remain	förbli
remainder	rest
remarkable	anmärkningsvärd
remedy	hela
remember	ihågkomma
remit	arbeställa
removal	flyttning
rent	hyra
rental	hyra
renter	hyresgäst
rent	hyra
rent	uthyra
repair	reparera
repay	återbetala
repeat	upprepa
repentance	ruelse
repertoire	repertoar
replete	mätt
reply	svara
report	rapportera
repose	rasta
representation	figur
representative	agent
reproach	förebrå
reproduction	reproduktion
reprove	förebrå
reptile	kräldjur
republic	republik
request	anmoda
require	behöva
rescue	rädda
resemblance	likhet
resemble	likna
resentment	agg
reservoir	bassäng
residence	boning
respect	harespektför
respiration	andhämtning
respond	svara
responsibility	ansvar
responsible	ansvarig
rest	rest
restaurant	restaurang
restrain	härska
restraint	självbehärskning
restrict	avgränsa
result	härstamma
retirement	pension
reveal	offentliggöra
revenge	hämnd
revolution	revolution
revolutionary	revolutionär
revolver	revolver
reward	belöna
rhino	noshörning
rhinoceros	noshörning
rhyme	rimma
rhythm	rytm
rice	ris
rich	rik
riddle	gåta
ride	rida
ridiculous	löjlig
rifle	gevär
right	korrekt
righteous	riktig
righteousness	rätt
rigid	styv
rim	brädd
ring	ring
riot	tumult
ripe	mogen
ripen	mogna
risk	riskera
ritual	ritual
rival	rival
river	flod
road	bana
roam	irra
roar	råma
roar	gapskratta
roast	halstra
roastbeef	rostbiff
rob	råna
robber	rånare
robe	klänning
rock	klippa
rocket	raket
roe	rådjur
rogue	niding
role	roll
roll	bulle
roller	rullgardin
roller	cylinder
rolling	stenrik
roof	tak
room	utrymme
rooster	tupp
root	rot
rope	lina
rose	ros
rostrum	tribun
rotten	rutten
rough	ovänlig
round	rund
round	runda
route	gång
routine	rutin
row	roddbåt
row	fil
rowan	rönnbär
rowing	roddbåt
royal	furstlig
rub	gnida
rubber	gummi
ruby	rubin
rudder	styre
rude	gensvarig
rudiments	alfabet
ruin	ruinera
rule	härska
ruler	linjal
rules	reglemente
rumor	rykte
rumour	rykte
rump	stjärt
run	springa
run	fly
run	söka
rust	rosta
rusty	rostig
rye	råg
r	regim
r	roll
sack	säck
sacrament	sakrament
sacred	helig
sad	ledsen
saddle	sadel
sadness	bedrövelse
safe	säker
safety	säkerhetsnål
safety	behåll
safety	säkerhetsnål
sagacious	klok
sage	klok
sail	segla
sailor	sjöman
saint	helgon
salad	salad
salamander	salamander
salary	arvode
sale	försäljning
sales	marknad
saliva	dregel
salivate	dregla
sallow	glåmig
salmon	lax
salon	salong
salt	salt
salty	salt
salt	saltvatten
salute	hälsa
salvage	räddning
salvation	räddning
sample	mönster
sanctuary	helgedom
sanctum	helgedom
sand	sandig
sand	sandig
sandal	sandal
sandbank	bank
sap	saft
sarcastic	sarkastisk
sardine	sardin
satisfied	belåten
sauce	spad
sauna	badstuga
sausage	korv
savage	ostyrig
save	rädda
saw	såga
say	säga
say	sägaadjö
say	sägaadjö
say	bejaka
scaffold	schavott
scale	fjäll
scandal	anstöt
scar	ärr
scarcely	knappast
scatter	gjuta
scene	scen
scenery	landskap
scent	doft
sceptre	scepter
schedule	kommunikationstabell
scheme	projekt
school	skola
science	vetenskap
scientific	vetenskaplig
scientist	vetenskapsman
scissors	sax
scold	förebrå
scrap	lapp
scratch	klå
scream	hojta
screw	skruva
screwdriver	skruvmejsel
scuffle	batalj
sculptor	bildhuggare
scythe	lie
sea	säl
sea	hav
seagull	fiskmås
seal	säl
seaside	kust
season	säsong
seat	sittplats
seaweed	alg
second	andra
secret	dold
secretary	sekretarere
sect	sekt
section	fack
secure	befästa
security	behåll
seduce	förföra
see	möta
seed	frö
seek	leta
seem	synas
self	självbehärskning
self	självförtroende
self	blyg
self	självbehärskning
self	självbehärskning
self	självförtroende
self	själv
sell	avyttra
send	sända
sender	adressant
sense	begrepp
sentence	mening
separate	särskild
serenade	serenad
serf	träl
sergeant	sergeant
series	serie
serious	viktig
sermon	predikan
serpent	orm
servant	städerska
service	tjänst
set	apparat
settlement	koloni
set	görabesviken
seven	sju
seventeen	sjutton
seventeenth	sjuttonde
seventh	sjunde
seventy	sjutti
several	alltemellanåt
sew	sy
sewer	avlopp
sex	kön
sexual	sexuell
shack	barack
shade	skugga
shadow	skugga
shallop	slup
shallow	grund
shame	blygsel
shamrock	klöver
shanty	barack
shape	bilda
share	aktie
shark	haj
sharp	amper
sharpen	skärpa
sharpness	skärpa
shatter	krossa
shave	raka
shawl	schal
she	åsninna
she	björnhona
she	get
she	varghona
she	hon
sheaf	knippa
shed	barack
sheep	får
sheet	blad
shell	snäcka
shelter	kasematt
shield	skylt
ship	fartyg
ship	slup
shirt	skjorta
shiver	bäva
shoe	skoband
shoe	sko
shoo	driva
shop	affär
shopkeeper	butiksinnehavare
shopping	affärsgata
shore	kust
short	kortsynt
short	gen
shortage	brist
shortcoming	brist
shorthand	snabbskrift
shorts	knäbyxor
short	knäbyxor
short	novell
should	böra
shoulder	axel
shout	hojta
show	uppvisa
shower	duscha
shrew	ragata
shrub	buske
shuffle	blanda
shy	blyg
shyness	blyghet
siblings	syskon
sick	dålig
side	avtagsväg
side	flank
sideboard	skåp
sidewalk	gångbana
siege	belägring
sieve	sikt
sift	harpa
sigh	sucka
sight	anblick
sign	skylt
sign	varsel
signal	signal
signature	namnteckning
signify	beteckna
silent	tyst
silhouette	silhuett
silk	avsiden
silk	avsiden
silken	avsiden
silkworm	silkesmask
sill	tröskel
silver	silver
similar	liknande
similarity	likhet
simple	simpel
simplify	förenkla
sin	synda
since	alltifrån
sinew	sena
sinful	syndig
sing	sjunga
singer	sångerska
singing	sång
single	ogift
sink	sjunka
sir	herr
sister	svägerska
sister	syster
sit	häcka
sitting	salong
situation	situation
six	sex
sixteen	sexton
sixteenth	sextonde
sixth	sjätte
sixtieth	sextionde
sixty	sexti
size	omfång
skeleton	benrangel
skeptical	klentrogen
skin	päls
skinflint	gnidare
skirt	kjol
skull	hjässa
sky	himmel
slander	bakdanta
slaughterhouse	slakthus
slave	slav
slay	avliva
sleep	sömn
sleeping	sängplats
sleeping	sovvagn
sleeping	sängplats
sleeve	ärm
slender	smal
slim	smäcker
slip	glida
slipper	toffel
slippery	hal
slogan	devis
sloop	slup
sloth	trögdjur
slow	långsam
sly	fiffig
smack	smacka
small	liten
smallpox	koppor
smart	fiffig
smash	krossa
smell	osa
smell	osa
smile	le
smith	smed
smoke	ryka
smokers	rökkupé
smokestack	skorsten
smooth	flack
smuggle	smuggla
snail	snigel
snake	orm
sneeze	nysa
snow	snö
snowdrop	snödroppe
snow	snövit
so	sålunda
soap	såpa
sobriquet	binamn
social	social
socialism	socialism
society	klubb
sock	socka
sofa	kanapé
soft	söt
soften	lena
softness	vekhet
soil	jord
soiled	smutsig
solair	solig
soldier	knekt
sole	fotsula
solicitor	advokat
solitary	ensam
soloist	solist
solve	lösa
some	någorlunda
somebody	någon
someone	någon
something	någonting
sometime	någonsin
sometimes	alltemellanåt
somewhat	någorlunda
somewhere	någonstans
some	någon
son	måg
son	son
sonata	sonat
song	visa
soon	snart
soot	sot
sorcery	trolleri
sorrel	syra
sorrow	bedrövelse
sorrowful	ledsen
sort	sort
sound	ljuda
sound	alarmere
soup	soppa
sour	surna
source	brunn
south	sydlig
southern	sydlig
sovereign	suverän
sow	so
so	lika...som
so	adjösålänge
spa	badort
space	utrymme
spaceman	rymdpilot
spacious	rymlig
spade	gräva
spare	spara
spare	ferier
spark	gnista
spark	gnista
sparrow	sparv
speak	tala
speaker	tribun
spear	lans
special	särskild
speciality	fack
specimen	mönster
spectacle	skådespel
spectacles	glasögon
speechless	stum
speed	hastighetsgräns
speed	fart
speed	hastighetsgräns
spell	stava
sphere	sfär
spider	spindel
spiderweb	spindelväv
spinach	spenat
spine	ryggrad
spinster	fröken
spiral	spiral
spirit	anda
spiritualism	spiritism
spite	agg
splinter	splittra
split	klyva
sponge	svamp
sponger	snyltgäst
spoon	sked
sporadic	sporadisk
sport	idrott
sportsman	sportsman
spot	ort
spray	pistol
spring	brunn
springtime	vår
spruce	gran
spruce	gran
spy	snoka
square	torg
square	flock
square	kvadratmeter
squatter	husockupant
squeeze	trycka
squirrel	ekorre
stab	sticka
stack	stack
stage	regissör
stage	station
staid	allvarlig
staircase	trappa
stairs	trappa
stake	påle
stalk	strå
stallion	hingst
stamp	frimärke
stamped	portofri
stanchion	påle
stand	kram
standard	standar
staple	spasm
star	stjärna
stare	stirra
starling	stare
start	begynna
state	hävda
statement	förklaring
statement	program
station	station
statistics	statistik
statue	bildstod
statute	statut
stay	förbli
stay	förbli
steak	biff
steam	dunst
steel	stål
stem	strå
stench	stank
stenography	snabbskrift
step	steg
steppe	stepp
sterile	steril
stew	ragu
stick	stav
stiff	ceremoniell
still	desslikes
sting	sticka
stingy	girig
stink	osa
stipulation	kondition
stocking	strumpa
stock	börs
stoic	stoisk
stoical	stoisk
stomach	mage
stomach	knip
stone	stenhuggare
stone	sten‐
stonemason	stenhuggare
stop	station
storage	batteri
storage	förvaringsställe
store	affär
storey	våning
stork	stork
storm	storma
story	våning
stove	kamin
straight	rak
straightedge	linjal
straightforward	simpel
strait	sund
strange	främmande
stranger	främling
strangle	strypa
straw	halm
strawberry	jordgubbe
stream	ström
street	gata
streetcar	spårvagn
strength	kraft
stress	accent
stride	steg
strike	banka
striking	påfallande
string	sena
strip	streck
stripe	streck
stroke	smeka
stroll	promenad
strong	kraftfull
struggle	kämpa
student	student
studio	ateljé
study	studera
stumble	snava
stupid	dum
sturgeon	stör
sty	stia
style	stil
subject	subjekt
subscribe	abonnera
subscriber	abonnent
subscribe	abonnera
subscription	abonnemang
subsidy	subsidier
substantive	substantiv
subterfuge	knep
subtle	subtil
suburb	förort
subway	tunnelbana
success	framgång
such	sådan
such	hur
such	hur
suck	suga
sudden	plötslig
suffer	lida
sugar	sockerskål
sugar	sockerrör
sugar	socker
sugarbowl	sockerskål
suggest	utpeka
suggestion	suggestion
suit	klädedräkt
sulphur	svavel
sum	belopp
summer	sommar
summon	kalla
sun	solig
sun	solig
sunbeam	solstråle
sunflower	solros
sunrise	soluppgång
sunset	solnedgång
superficial	grund
superior	överman
superstition	skrock
superstitious	vantrogen
supervise	besiktiga
supper	aftonmåltid
supply	avleverera
support	stödja
supporter	partigängare
supporters	anhang
suppose	anta
sure	given
surely	ju
surgeon	kirurg
surgical	kirurgisk
surgical	operation
surly	ovänlig
surmise	anta
surname	efternamn
surpass	överstiga
surprise	förvåning
surround	kringgå
suspect	misstro
suspicion	misstro
suspicious	misstrogen
sustain	stödja
sustained	konstant
swallow	svala
swamp	kärr
swan	svan
swarm	svärm
swear	svära
sweat	svettas
sweep	sopa
sweet	söt
swim	simma
swimming	bassäng
swimming	bassäng
swimming	simbyxor
swindle	bedrägeri
swine	gris
swing	svinga
swoon	svimma
sword	svärd
sycamore	lönn
syllable	stavelse
symbol	symbol
symmetric	symmetrisk
sympathetic	anslående
sympathy	sympati
symphony	symfoni
synagogue	synagoga
syrup	sirap
system	system
systematic	systematisk
table	bordduk
table	tabell
tablet	tabell
tabulation	tabell
tail	baklykta
tail	stjärt
tailor	skräddare
take	tackajatill
take	tahänsyntill
take	medbringa
take	slopa
take	tackajatill
take	tahänsyntill
take	sägaadjö
take	sägaadjö
take	retasigpå
take	anskaffa
taking	anskaffning
taking	anskaffning
tale	berättelse
talent	begåvning
talk	tala
talkative	språksam
tame	tam
tangerine	mandarin
tangle	kaos
tank	behållare
tapestry	tapet
tar	tjära
tart	tårta
taste	smak
tasteless	smaklös
tasty	läcker
tax	taxera
taxi	droskbil
tea	tekanna
tea	te
teach	undervisa
teacher	lärarinna
tear	tår
technical	teknisk
technics	teknik
technique	teknik
teeth	bett
teetotaller	absolutist
telegram	telegram
telegraph	telegrafera
telephone	anropa
telephone	telefonhytt
telephone	telefonhytt
television	television
tell	säga
tell	ljuga
temper	humör
temperature	temperatur
temple	tinning
tempt	förföra
temptation	förförelse
ten	tie
tenant	hyresgäst
tendency	håg
tender	söt
tenderness	vekhet
tendon	sena
tend	ansa
tenor	tenor
tenth	tionde
term	term
terminate	fullborda
terms	kondition
term	skällsord
terrace	terrass
terraced	radhus
terrace	radhus
terrain	terräng
terrible	förfärlig
territory	mark
terrorism	terrorism
test	examen
testament	testamente
testify	attestera
testimony	attest
text	text
textile	väv
than	än
thank	tacka
thankful	tacksam
thankless	otacksam
thanks	tack
thank	tackaför
thank	tackskaduha
thank	tacksåmycket
that	vad
that	detgöringenting
that	detgöringenting
that	detvarsynd
that	sådan
that	sålunda
thaw	töväder
theatre	teater
theatre	skådespel
theft	stöld
their	sin
theme	tema
theory	teori
there	dit
thermometer	termometer
these	nutida
the	Sydpolen
the	Nordpolen
the	JonBlund
the	Nederländerna
the	JonBlund
the	Ukraina
the	suggestion
thick	diger
thickness	tjockhet
thief	tjuv
thigh	höft
thin	smal
thing	objekt
think	anse
think	begrunda
third	tredje
thirst	törst
thirsty	törstig
thirteen	tretton
thirteenth	trettonde
thirty	tretti
this	iafton
this	hit
thither	dit
thorn	tagg
thou	du
though	ehuru
thought	tanke
thousand	tusen
thread	garn
threat	hot
threaten	hota
three	tre
threshold	tröskel
thrifty	njugg
throat	strupe
throb	pulsera
throne	tron
through	per
throw	kasta
throw	kräkas
thrush	talltrast
thrust	puffa
thumb	tumme
thunder	tordön
thus	sålunda
ticket	biljett
tidy	inreda
tie	binda
tie	binda
tiger	tiger
tile	häll
till	kassa
tillage	jordbruk
timber	trä
time	kommunikationstabell
time	gång
time	ferier
timidity	blyghet
tin	tenn
tiny	liten
tip	tipp
tired	trött
tired	genomtrött
title	titel
titmouse	mes
to	på
toad	padda
toast	halstra
tobacco	tobak
toe	tå
toga	toga
together	ihop
toilet	toalettpapper
toilet	avträde
token	bevis
tolerant	tolerant
tolerate	tåla
tomato	tomat
tomb	graf
tone	ton
tongue	tunga
too	också
tool	instrument
tooth	tandborste
tooth	tandkräm
tooth	tand
toothache	tandvärk
toothpick	tandpetare
too	alltför
topgallant	braxen
topic	tema
torch	bloss
tortoise	sköldpadda
torture	martera
torturer	bödel
total	total
total	absolutist
touch	beröra
tourist	turist
tourist	resebyrå
toward	på
towards	på
tower	torn
town	rådhus
town	köping
town	rådhus
toy	leksak
to	någorlunda
trade	handla
tradition	praxis
traditional	hävdvunnen
traffic	trafik
train	järnvägståg
tram	spårvagn
transformation	ändring
transgress	synda
transgression	synd