ABC	abc
ABC book	abécédaire
AIDS	sida
Abkhazia	Abkhasie
Abkhazian	abkhasien
Abyssinia	Abyssinie
Abyssinian	abyssin
Acheron	Achéron
Achilles	Achille
Achilles' heel	talon d'Achille
Achilles' tendon	tendon d'Achille
Adam	Adam
Addis Ababa	Addis‐Abeba
Aden	Aden
Adonis	Adonis
Adrianople	Andrinople
Adriatic	mer Adriatique
Adriatic Sea	mer Adriatique
Adzharia	Adjarie
Aegean	mer Egée
Aegean Sea	mer Egée
Aeneas	Enée
Aeolus	Eole
Afghan	afghan
Afghanistan	Afghanistan
Afghan woman	Afghane
Africa	Afrique
African	africain
Afrikaans	d'Afrikanders
Afrikaner	Afrikander
Afro‐Asian	afro‐asiatique
Again River	rivière Again
Agamemnon	Agamemnon
Agatha	Agathe
Aix‐la‐Chapelle	Aix‐la‐Chapelle
Ajax	Ajax
Albania	Albanie
Albanian	albanais
Albert	Albert
Alberta	Alberta
Alderney	Aurigny
Aleppo	Alep
Alexander	Alexandre
Alexandria	Alexandrie
Algeria	Algérie
Algerian	algérien
Algiers	Alger
Allumette Lake	lac aux Allumettes
All Hallows	Toussaint
All Saints' Day	Toussaint
Alost	Alost
Alpenrose	rhododendron
Alpinist	alpiniste
Alps	Alpes
Alsatian	Alsacien
Alva	Albe
Amazon	amazone
Amboina	Amboine
America	Amérique
American	américain
Americanize	américaniser
American Indian	Indien
Amsterdam	Amsterdam
Andalusia	Andalousie
Andalusian	andalou
Andalusian woman	Andalouse
Andorra	Andorre
Andorrian	andorran
Anglican	anglican
Anglicism	anglicisme
Anglo‐Saxon	anglo‐saxon
Angolan	angolais
Angolese	Angolais
Ann	Anne
Annunciation	Annonciation
Antarctic	Antarctique
Antarctic Ocean	océan Antarctique
Antichrist	antéchrist
Anticosti Island	Ile d'Anticosti
Antilles	Antilles
Antillian	antillais
Antioch	Antioche
Antony	Antoine
Antwerp	Anvers
Apennines	Apennins
Aphrodite	Aphrodite
Apocalypse	Apocalypse
Apollo	Apollon
Appalachian Mountains	Appalaches
April	avril
Aquarius	Verseau
Aquitaine	Aquitaine
Arab	Arabe
Arabia	Arabie
Arabian	arabe
Arabian woman	Arabe
Arabic	arabe
Arcadia	Arcadie
Archimedes	Archimède
Arctic	arctique
Arctic Ocean	océan Arctique
Ardennes	Ardennes
Argentina	Argentine
Argentine	argentin
Argentinean	argentin
Argus	Argus
Ariadne	Ariane
Aristotle	Aristote
Armenia	Arménie
Armenian	arménien
Armenian woman	Arménienne
Armorica	Armorique
Armstrong Creek	ruisseau Armstrong
Arras	Arras
Aryan	aryen
Asia	Asie
Asian	Asiate
Asian woman	Asiate
Asia Minor	Asie Mineure
Assumption	Assomption
Assyria	Assyrie
Assyrian	assyrien
Asturias	Asturies
Athabasca	Atabasca
Athena	Athènes
Athene	Athènes
Athenian	athénien
Athens	Athènes
Atlantean	atlantique
Atlantic	océan Atlantique
Atlantic Ocean	océan Atlantique
Atlas	Atlas
Attica	Attique
Augeas	Augias
August	août
Augustus	Auguste
Australia	Australie
Australian	australien
Australian woman	Australienne
Austria	Autriche
Austrian	autrichien
Aztec	aztèque
Babel	Babel
Babylon	Babel
Babylonia	Babylonie
Babylonian	babylonien
Bacchus	Bacchus
Baffin Bay	baie de Baffin
Baffin Island	Ile de Baffin
Balearic Islands	Baléares
Balinese	balinais
Balkans	Balkans
Baltic	balte
Baltic Sea	mer Baltique
Bantu	bantou
Barbados	Barbade
Barcelona	Barcelone
Bartolomew	Barthélemy
Basque	basque
Batavian	batave
Bavaria	Bavière
Bavarian	bavarois
Bay of Fundy	baie de Fundy
Beaufort Sea	mer de Beaufort
Bedouin	Bédouin
Belgian	belge
Belgian woman	Belge
Belgium	Belgique
Belgrade	Belgrade
Ben	Benoît
Benedict	Benoît
Benedict Brook	ruisseau Benedict
Benelux	Benelux
Bengal	Bengale
Berlin	Berlin
Berliner	Berlinois
Bermudas	Bermudes
Berne	Berne
Bernese	bernois
Bessarabia	Bessarabie
Bethlehem	Bethléem
Bible	Bible
Black Forest	Forêt‐Noire
Black Sea	Pont‐Euxine
Black Volta	Volta Noire
Bluebeard	Barbe‐Bleue
Boer	Afrikander
Bohemia	Bohême
Bohemian	bohémien
Bois‐le‐Duc	Bois‐le‐Duc
Bolivia	Bolivie
Bolivian	bolivien
Bosnia	Bosnie
Bosnian	bosniaque
Bosporus	Bosphore
Boundary Bay	baie chez Lepage
Boundary Hill	colline Boundary
Boundary Lakes	lacs de la Frontière
Brabant	Brabant
Brabantine	brabançon
Brazil	Brésil
Brazilian	brésilien
Bretagne	Bretagne
Breton	Breton
Britain	Grande‐Bretagne
British	britannique
British Columbia	Colombie‐Britannique
Briton	Britannique
Brittany	Bretagne
Bruges	Bruges
Brussels	Bruxelles
Buddha	Bouddha
Buddhism	bouddhisme
Buddhist	bouddhiste
Bujeault River	rivière Bujeault
Bulgar	Bulgare
Bulgarian	bulgare
Burma	Birmanie
Burmese	birman
Burmese woman	Birmane
Burwash Creek	ruisseau Burwash
Bushman	Boschiman
Byzantine	byzantin
Byzantium	Byzance
Cabot Strait	détroit de Cabot
Caesar	César
Cain	Caïn
Cairo	Le Caire
Caissie Cape	Cap‐des‐Caissie
Calabria	Calabre
California	Californie
Californian	californien
Calvary	Calvaire
Calvin	Calvin
Cambodia	Cambodge
Cambodian	cambodgien
Cambodian woman	Cambodgienne
Cameroon	Cameroun
Canaan	Chanaan
Canada	Canada
Canadian	canadien
Canadian woman	Canadienne
Canary Islands	îles Canaries
Candlemas	Chandeleur
Cape Breton Island	Ile du Cap‐Breton
Capitol	Capitole
Capricorn	Capricorne
Carpathians	Carpates
Carpathian mountains	Carpates
Carthage	Carthage
Carthaginian	carthaginois
Caspian Sea	mer Caspienne
Cassandra	Cassandre
Castile	Castille
Castilian	Castillan
Castillian	castillan
Catalonia	Catalogne
Catalonian	catalan
Cato	Caton
Caucasus	Caucase
Cedar Brook	ruisseau Cedar
Celt	Celte
Celtic	celte
Central America	Amérique centrale
Cerberus	Cerbère
Ceres	Cérès
Ceylon	Ceylan
Ceylonese	ceylanais
Chad	Tchad
Chaldea	Chaldée
Chaldean	Chaldéen
Chaleur Bay	baie des Chaleurs
Chanion Brook	ruisseau Chanion
Channel	la Manche
Channel Islands	Iles normandes
Charlemagne	Charlemagne
Charybdis	Charybde
Cheeseman Lake	lac des Marets
Chile	Chili
Chilean	chilien
China	Chine
Chinaman	Chinois
Chinese	Chinois
Chisholm Brook	ruisseau Chisholm
Chiyask Bay	baie Chiyask
Christ	Christ
Christian	chrétien
Christian name	prénom
Churchill	Churchill
Churchill River	Churchill
Cicero	Cicéron
Cinderella	Cendrillon
Clarice Lake	lac Clarice
Cleopatra	Cléopâtre
Coast Mountains	chaîne Côtière
Coblenz	Coblence
Cologne	Cologne
Colombia	Colombie
Colombian	colombien
Columbia	Columbia
Columbia River	Columbia
Columbus	Colomb
Comine	Comines
Congo	Congo
Copenhagen	Copenhague
Cordova	Cordoue
Corinth	Corinthe
Corinthian	corinthien
Cornwall	Cornouailles
Corpus Christi	fête‐Dieux
Corsica	Corse
Corsican	corse
Corsican woman	Corse
Costa Rica	Costa Rica
Costa Rican	costaricien
Courtrai	Courtrai
Cracow	Cracovie
Crete	Crète
Crimea	Crimée
Croat	Croate
Croatia	Croatie
Croatian	croate
Cuba	Cuba
Cuban	Cubain
Culbute Channel	chenal de la Culbute
Cupid	Cupidon
Curaçao	Curaçao
Cyclades	Cyclades
Cyprian woman	Chypriote
Cypriot	chypriote
Cypriote	chypriote
Cyprus	Chypre
Czech	tchèque
Czechoslovak	tchécoslovaque
Czechoslovakia	Tchécoslovaquie
Czechoslovakian	tchécoslovaque
Czech language	tchèque
Czech woman	Tchèque
DNA	ADN
Dakar	Dakar
Dalmatia	Dalmatie
Dalmatian	Dalmate
Damascus	Damas
Damocles	Damoclès
Dane	Danois
Danube	Danube
Dardanelles	Dardanelles
Davis Strait	détroit Davis
December	décembre
Delphi	Delphes
Denmark	Danemark
Deschênes Rapids	rapides Deschênes
Detour River	rivière du Détour
Deuteronomy	Deutéronome
Devil's Island	Ile du Diable
Diana	Diane
Diogenes	Diogène
District of Franklin	district de Franklin
District of Keewatin	district de Keewatin
District of Mackenzie	district de Mackenzie
Djibouti	Djibouti
Dominica	Républic Dominicaine
Dominican	dominicain
Donquan Lake	lac Donquan
Don Quixote	don Quichotte
Dorian	dorien
Doric	dorien
Dover	Douvres
Dunkirk	Dunkerque
Dutch	néerlandais
Dutchman	Hollandais
Dutch Flanders	Flandre Zélandaise
Dutch language	néerlandais
Dutch woman	Néerlandaise
East	est
Easter	Pâques
East Natasquan River	rivière Natashquan Est
East Rigaud River	rivière Rigaud Est
Eden	Eden
Edinburgh	Edimbourg
Egypt	Egypte
Egyptian	égyptien
Elba	Elbe
Elbe	Elbe
Ellesmere Island	Ile d'Ellesmere
England	Angleterre
English	anglais
Englishman	Anglais
English Channel	la Manche
English language	anglais
Epiphany	Epiphanie
Equatorial Guinea	Guinée Equatoriale
Eritrea	Erythrée
Esperanto	espéranto
Estonia	Estonie
Estonian	estonien
Estonian woman	Estonienne
Ethiopia	Ethiopie
Ethiopian	éthiopien
Etrurian	étrusque
Etruscan	étrusque
Euphrates	Euphrate
Europa	Europe
Europe	Europe
European	Européen
European Union	Union Européenne
Euxine Sea	Pont‐Euxine
Evening Star	Vénus
Far East	Extrême‐Orient
February	février
Filipino	Philippin
Finland	Finlande
Finn	Finnois
Finnish	finlandais
Finnish woman	Finlandaise
Flanders	Flandre
Flemming	Flamand
Flemmish	flamand
Florida	Floride
Flushing	Flessingue
Fonteneau Lake	lac Fonteneau
Fortune	Fortune
France	France
Frankfort	Francfort
Frankish	franc
Fraser	Fraser
Fraser River	Fraser
French	français
Frenchman	Français
Frenchwoman	Française
French language	français
Friday	vendredi
Friesland	Frise
Frisian	frisonne
Frisian woman	frisonne
Gabon	Gabon
Gaelic	gaélique
Gaelic language	gaélique
Gaillot Lake	lac Gaillot
Galicia	Galice
Galician	galicien
Gallic	gaulois
Ganges	Gange
Gaul	Gaule
Gaulish	gaulois
Genesis	Genèse
Geneva	Genève
Genoa	Gênes
Georgia	Géorgie
Georgian	géorgien
Georgian Bay	baie Georgienne
A	allemand
Germanic	germain
Germany	Allemagne
German language	allemand
German woman	Allemande
Ghana	Ghana
Ghanaian	Ghanéen
Ghent	Gand
Gideon	Gédéon
God	Dieu
God's acre	cimetière
Golgotha	Calvaire
Goth	Goth
Gothic	gothique
Graian Alps	Alpes graies
Grammont	Grammont
Grand Falls	Grand‐Sault
Great Bear Lake	grand lac de l'Ours
Great Britain	Grande‐Bretagne
Great Salt Lake	Grand Lac Salé
Great Slave Lake	grand lac des Esclaves
Greece	Grèce
Greek	grec
Greek woman	Grecque
Greenland	Groënland
Greenlander	Groënlandais
Green River	rivière Verte
Grenada	Grenade
Guadeloupe	Guadeloupe
Guatemala	Guatemala
Guatemalan	guatémaltèque
Guelderland	Gueldre
Guelders	Gueldre
Guinea	Guinée
Guinea Bissau	Guinée‐Bissau
Gulf of Aden	Golfe d'Aden
Gulf of Saint Lawrence	golfe du Saint‐Laurent
Gypsy	gitan
Haiti	Haïti
Hamburg	Hambourg
Hannibal	Annibal
Hanover	Hanovre
Harricanaw River	rivière Harricana
Havana	La Havane
Hawaii	Hawaii
Hawaiian	hawaiien
Hawaiian language	hawaiien
Hebrew	hébraïque
Hebrew language	hébreu
Hebrides	Hébrides
Helen	Hélène
Hellas	Hellade
Hellespont	Dardanelles
Helvetia	Helvétie
Helvetian	Helvète
Heracles	Hercule
Hercules	Hercule
Hermes	Hermès
Himalayas	Himalaya
Hindu	hindou
Hippocrates	Hippocrate
Holden Lake	lac Holden
Holland	Hollande
Hollander	Hollandais
Homer	Homère
Honduran	hondurien
Honduran woman	Hondurienne
Honduras	Honduras
Hongkong	Hong Kong
Hudson Bay	baie d'Hudson
Hungarian	hongrois
Hungarian woman	Hongroise
Hungary	Hongrie
Iberian	ibère
Iceland	Islande
Icelander	Islandais
Icelandic	d'Islande
Iliad	Iliade
India	Inde
Indian	indien
Indian corn	maïs
Indian woman	Indienne
Indo‐China	Indochine
Indonesia	Indonésie
Indonesian	indonésien
Indonesian woman	Indonésienne
Iran	Iran
Iranian	iranien
Iranian woman	Iranienne
Iraq	Irak
Iraqi	irakien
Iraquian	irakien
Ireland	Irlande
Irish	irlandais
Irishman	Irlandais
Irish Sea	mer d'Irlande
Iriswoman	Irlandaise
Islam	islam
Israel	Israël
Italian	italien
Italian woman	Italienne
Italy	Italie
Ivory Coast	Côte d'Ivoire
Jacob	Jacob
Jamaica	Jamaïque
James Bay	baie James
January	janvier
Japan	Japon
Japanese	japonais
Japanese language	japonais
Japanese woman	Japonaise
Java	Java
Javan	javanais
Javanese	javanais
Javanese woman	Javanaise
Jericho	Jéricho
Jerusalem	Jérusalem
Jesus Christ	Jésus‐Christ
Jew	Hébreu
Jewish	hébraïque
Jibuti	Djibouti
Joir River	rivière Joir
Jordan	Jordanie
Jordanian	Jordanien
Joseph	Joseph
Joshua	Josué
Jove	Jupiter
Julian Creek	ruisseau Julian
July	juillet
June	juin
Juno	Junon
Jupiter	Jupiter
Kachekaosipou River	rivière Kachekaosipou
Kashmir	Cachemire
Kenosha Island	Ile Kénosha
Kenya	Kenya
Kenyan	kenyan
Kingroy Lake	lac Kingroy
Koblenz	Coblence
Koran	Coran
Korea	Corée
Korean	coréen
Korean woman	Coréene
Kremlin	Kremlin
Kurd	Kurde
Kurdish	kurde
Kurdistan	Kurdistan
LP	microsillon
Labrador Sea	mer du Labrador
Labyrinth Lake	lac Labyrinthe
Lady Day	Annonciation
Lake Athabasca	lac Athabasca
Lake Champlain	lac Champlain
Lake Huron	lac Huron
Lake Michigan	lac Michigan
Lake Ontario	lac Ontario
Lake Saint Clair	lac Sainte‐Clair
Lake Superior	lac Supérieur
Lake Timiskaming	lac Témiscamingue
Lake Winnipeg	lac Winnipeg
Lake Winnipegosis	lac Winnipeg
Lake of Geneva	Lac Léman
Lake of the Woods	lac des Bois
Laos	Laos
Laotian	laotien
Lapland	Laponie
Laplander	Lapon
Lapp	lapon
Lappish	lapon
Lappish woman	Laponne
Lapponian woman	Laponne
Latin	latin
Latvia	Lettonie
Latvian	letton
Latvian woman	Lettonne
Laurentian Mountains	Laurentides
Lebanese	libanais
Lebanon	Liban
Leghorn	Livourne
Lett	Letton
Lettish	letton
Leyden	Leyde
Liberia	Libéria
Liberian	libérien
Libya	Libye
Libyan	libyen
Lisbon	Lisbonne
Lithuania	Lituanie
Lithuanian	Lituanien
Lithuanian woman	Lituanienne
Little Mecatina River	rivière du Petit Mécatina
Livonia	Livonie
Livonian	livonien
Liège	Liège
London	Londres
Londoner	Londonien
Lorraine	Lorraine
Lost Channel	Chenal Lost
Lothringen	Lorraine
Louvain	Louvain
Lower Narrows	Passe Lower
Lucerne	Lucerne
Lucifer	Satan
Luxemburg	Luxembourg
Luxemburger	Luxemburgeois
Lyons	Lyon
Lyra	Lierre
Mabille Lake	lac Mabille
Macedonia	Macédoine
Macedonian	macédonien
Machiavelli	Machiavel
Mackenzie	Mackenzie
Mackenzie River	Mackenzie
Madagascar	Madagascar
Madawaska River	rivière Madawaska
Madonna	Madone
Madrid	Madrid
Magusi River	rivière Magusi
Majorca	Majorque
Malawi	Malawi
Malay	malais
Malaysia	Malaisie
Malaysian	malaisien
Mali	Mali
Malines	Malines
Malta	Malte
Maltese	maltais
Mammon	Mammon
Manchuria	Mandchourie
Manchurian	mandchou
Manila	Manille
Manitoba	Manitoba
March	mars
Marcus	Marc
Mariana Islands	Mariannes
Maroni	Maroni
Mars	Mars
Marseilles	Marseille
Mary	Marie
Mason	franc‐maçon
Matterhorn	mont Cervin
Mauretanian	mauritanien
Mauritania	Mauritanie
Mauritius	île Maurice
May	mai
Mayence	Mayence
McDiarmid Creek	ruisseau McDiarmid
Mecca	Mecque
Mechlin	Malines
Mediterranean	Méditerranée
Medusa	Méduse
Melanesia	Mélanésie
Melanesian	mélanésien
Mephistopheles	Méphistophélès
Mercereau River	rivière Mercereau
Mercury	Mercure
Mesopotamia	Mésopotamie
Messiah	Messie
Messina	Messine
Methuselah	Mathusalem
Meuse	Meuse
Mexican	mexicain
Mexican woman	Mexicaine
Mexico	Mexique
Mexico City	Mexico
Middle East	Proche‐Orient
Milan	Milan
Minerva	Minerve
Ministikawatin Peninsula	Péninsule Ministikawatin
Miss	demoiselle
Mister	monsieur
Mohammed	Mahomet
Moldavia	Moldavie
Moldavian	moldave
Moluccan	moluquois
Moluccas	Moluques
Monacan	Monégasque
Monaco	Monaco
Monday	lundi
Monegasque	monégasque
Mongolia	Mongolie
Montenegrin	monténégrin
Montenegro	Monténégro
Moor	Maure
Moorish	maure
Moravia	Moravie
Moresque	maure
Moroccan	marocain
Morocco	Maroc
Morpheus	Morphée
Moscow	Moscou
Moselle	Moselle
Moses	Moïse
Mount Caubvick	mont d'Iberville
Mr.	monsieur
Mrs.	madame
Muhammad	Mahomet
Munich	Munich
Muscovite	moscovite
Mycenae	Mycènes
Namur	Namur
Nanking	Nankin
Napetipi River	rivière Napetipi
Naples	Naples
Natashquan River	rivière Natashquan
Neapolitan	napolitain
Nebuchadnezzar	Nabuchodonosor
Negro	nègre
Nelson	Nelson
Nelson River	Nelson
Nemesis	Némésis
Nepal	Népal
Nepalese	népalais
Neptune	Neptune
Newfoundland	Terre‐Neuve
New Brunswick	Nouveau‐Brunswick
New Guinea	Nouvelle‐Guinée
New Orleans	Nouvelle‐Orléans
New South Wales	Nouvelle‐Galles du Sud
New Year	jour de l'an
New Year's Day	jour de l'an
New Year's Eve	Saint‐Sylvestre
New Zealand	Nouvelle‐Zélande
New Zealander	Néo‐Zélandais
Niagara Falls	Chutes Niagara
Nicaragua	Nicaragua
Nicaraguan	nicaraguayen
Niger	Niger
Nigeria	Nigeria
Nigerian	nigérian
Nigerien	nigérien
Nile	Nil
Nimrod	Nemrod
Nimwegen	Nimègue
Nipigon Lake	lac Nipigon
Noah	Noé
Norman	normand
Norman Lake	lac Norman
Norman Rapids	rapides Norman
Norseman	Normand
North	nord
Northern Ireland	Irlande du Nord
Northman	Normand
Northumberland Strait	détroit de Northumberland
Northwest Territories	territoires du Nord‐Ouest
North Africa	Afrique du Nord
North African	nordafricain
North America	Amérique du Nord
North American	de l'Amérique du Nord
North Branch Kedgwick River	rivière Kedgwick
North Branch States Brook	ruisseau States Nord
North Holland	Hollande septentrionale
North Korea	Corée du Nord
North Korean	nord‐coréen
North Saskatchewan	rivière Saskachewan Nord
North Saskatchewan River	rivière Saskachewan Nord
North Sea	mer du Nord
Norway	Norvège
Norwegian	norvégien
Norwegian woman	norvégienne
Nova Scotia	Nouvelle‐Ecosse
Nova Skotia	Nouvelle‐Ecosse
November	novembre
Nuremberg	nurembergeois
Oceania	Océanie
Oceanica	Océanie
October	octobre
Oedipus	Œdipe
Olympus	Olympe
Ontario	Ontario
Opimika Narrows	chenal Opimica
Oporto	Porto
Orange	Orange
Orkneys	Orcades
Orkney Islands	Orcades
Orpheus	Orphée
Ostend	Ostende
Ostende	Ostende
Ostrogoth	Ostrogoth
Ottawa River	rivière des Outaouais
PVC	chlorure de polyvinyle
Pacific	Pacifique
Pacific Ocean	Pacifique
Pakistan	Pakistan
Pakistani	pakistanais
Pakistani woman	Pakistanaise
Palestine	Palestinien
Palestinian	Palestine
Palm Sunday	Rameaux
Pan	Pan
Panama	Panama
Panamanian	panaméen
Panamanian woman	Panaméenne
Pandora	Pandore
Papuan	Papou
Paris	Pâris
Parisian	Parisien
Parthian	part
Patapedia River	rivière Patapédia
Peace River	rivière de la Paix
Pegasus	Pégase
Peiping	Pékin
Peking	Pékin
Penelope	Pénélope
Pentateuch	Pentateuque
Pentecost	Pentecôte
Persia	Iran
Persian	Iranien
Persian Gulf	golfe Persique
Persian woman	Iranienne
Peru	Pérou
Philippine	des Philippines
Philippines	Philippines
Philippine Islands	Philippines
Philippine woman	Philippine
Piscapecassy River	rivière Piscapecassy
Plato	Platon
Pluto	Pluton
Poland	Pologne
Pole	Polonais
Polish	polonais
Polish woman	Polonaise
Pollard Brook	ruisseau Pollard
Polynesia	Polynésie
Polynesian	polynésien
Pomerania	Poméranie
Pontiac Creek	ruisseau Pontiac
Pontleroy Creek	ruisseau Pontleroy
Portugal	Portugal
Portuguese	portugais
Portuguese language	portugais
Portuguese woman	Portugaise
Prague	Prague
Prices Brook	ruisseau Prices
Prince Edward Island	Ile‐du‐Prince‐Edouard
Protestant	protestant
Proteus	Protée
Prussia	Prusse
Prussian	prussien
Ptolemy	Ptolémée
Quebec	Québec
Queen Charlotte Islands	Iles de la Reine‐Charlotte
Queen Elizabeth Islands	Iles de la Reine‐Elisabeth
Quigley Brook	ruisseau Quigley
Raft Channel	chenal Raft
Rainy Lake	lac à la Pluie
Rainy River	rivière à la Pluie
Ratisbon	Ratisbonne
Remic Rapids	rapides Remic
Remprouix Island	Ile Remprouix
Restigouche River	rivière Ristigouche
Rheims	Reims
Rhine	Rhin
Rhineland	Rhénanie
Rhine barge	péniche
Rhodesia	Rhodésie
Rhone	Rhône
Richard	Richard
Rigaud River	rivière Rigaud
Rimouski River	rivière Rimouski
Rocky Mountains	montagnes Rocheuses
Roman	Romain
Romania	Roumanie
Romanian	roumain
Romanian woman	Roumaine
Roman Empire	Empire romain
Rome	Rome
Ross Lake	lac Ross
Rubicon	Rubicon
Rumanian	roumain
Russia	Russie
Russian	russe
Russian language	russe
Russian woman	Russe
Sable Island	Ile de Sable
Sagittarius	Sagittaire
Saguenay River	rivière Saguenay
Sahara	Sahara
Saint Augustin River	rivière Saint‐Augustin
Saint Francis River	rivière Saint‐François
Saint Helena	Sainte‐Hélène
Saint John River	rivière Saint‐Jean
Saint Lawrence	fleuve Saint‐Laurent
Saint Lawrence River	fleuve Saint‐Laurent
Saint Nicholas	Saint‐Nicolas
Saint Paul River	rivière Saint‐Paul
Saint Petersburg	Saint‐Pétersbourg
Samaria	Samarie
San Marino	Saint‐Marin
Sardina	Sardaigne
Sardinia	Sardaigne
Sardinian	Sarde
Sassenach	Anglais
Satan	Satan
Saturday	samedi
Saturn	Saturne
Saugeen Creek	ruisseau Saugeen
Saxe	Saxe
Saxon	Saxon
Saxony	Saxe
Scandinavia	Scandinavie
Scandinavian	scandinave
Scandinavian woman	Scandinave
Scheldt	Escaut
Scilly Islands	îles Sorlingues
Scot	Ecossais
Scotland	Ecosse
Scotsman	Ecossais
Scotswoman	Ecossaise
Scylla	Scylla
Second Falls	deuxième Sault
Sein	Seine
Semite	Sémite
Semitic	sémitique
Senegal	Sénégal
Senegalese	Sénégalais
September	septembre
Serb	serbe
Serbia	Serbie
Seville	Séville
Seychelles	Seychelles
Siam	Siam
Siamese	siamois
Siberia	Sibérie
Siberian	sibérien
Sicilian	sicilien
Sicilian woman	Sicilienne
Sicily	Sicile
Singapore	Singapour
Singaporean	singaporien
Sisson Brook	ruisseau Sisson
Slav	Slave
Slavic	slave
Slavonian	slavon
Slovak	slovaque
Slovakia	Slovaquie
Slovak woman	Slovaque
Slovene	Slovène
Slovenia	Slovénie
Slovenian	slovène
Sofia	Sophie
Somali	somalien
Somalia	Somalie
Somalian	somalien
Sout‐East Asia	Asie du Sud‐Est
Southern Cross	Croix du Sud
South Africa	Afrique du Sud
South African	sud‐africain
South America	Amérique du Sud
South American	sud‐américain
South Korea	Corée du Sud
South Saskatchewan	rivière Saskachewan Sud
South Saskatchewan River	rivière Saskachewan Sud
Spain	Espagne
Spaniard	Espagnol
Spanish	espagnol
Spanish language	espagnol
Spanish woman	Espagnole
Sparta	Sparte
Spitsbergen	Spitzberg
St. Nicholas	Saint‐Nicolas
Strait of Belle Isle	détroit de Belle Ile
Strasbourg	Strasbourg
Styria	Styrie
Styx	Styx
Sudan	Soudan
Sudanese	soudanais
Sunday	dimanche
Sunday Creek	ruisseau Sunday
Sunrise Creek	ruisseau Sunrise
Surinam	Surinam
Surinamer	Surinamien
Surinamese	surinamien
Surinamese woman	Surinamienne
Swede	Suédois
Sweden	Suède
Swedish	suédois
Swiss	suisse
Switzerland	Suisse
Syria	Syrie
Syrian	syrien
Sénécal Lake	lac Sénécal
TV	télévision
Tagus	Tage
Talmud	Talmud
Tangier	Tanger
Tantalus	Tantale
Tanzania	Tanzanie
Tanzanian	tanzanien
Tartar	Tatare
Tatar	tatare
Teed Brook	ruisseau Teed
Teuton	Germain
Teutonic	germain
Texan	Texan
Texan woman	Texane
Texas	Texas
Thai	siamois
Thailand	Siam
Thai woman	Thaïlandaise
Thames	Tamise
The Hague	La Haye
Thursday	jeudi
Tiber	Tibre
Tiberius	Tibère
Tibet	Tibet
Tibetan	tibétain
Tigris	Tigre
Togo	Togo
Togoland	Togo
Tokyo	Tokyo
Tom Thumb	Petit Poucet
Torngat Mountains	monts Torngat
Transylvania	Transylvanie
Treves	Trèves
Trojan	Troyen
Troy	Troie
Tuesday	mardi
Tunis	Tunis
Tunisia	Tunesie
Turcotte River	rivière Turcotte
Turin	Turin
Turk	Turc
Turkey	Turquie
Turkish lady	Turque
Turkish woman	Turque
Turkmenistan	Turkménistan
Twelfth‐night	Epiphanie
Tyrrhenian Sea	mer Tyrrhénienne
‐able	‐able
‐er	‐iste
‐ever	n'importe
‐ible	‐able
‐in‐law	par alliance
‐ish	‐al
‐ist	‐iste
‐ity	‐té
‐like	‐al
‐ness	‐té
‐or	‐iste
‐ship	‐té
‐th	‐ième
‐y	suffixe qui indique un lieu pour quelque chose
USA	Etats‐Unis
US citizen	Américain
Ukraine	Ukraine
Ukrainian	ukrainien
Ukrainian woman	Ukrainienne
Ulysses	Ulysse
Ungava Bay	baie d'Ungava
United States of America	Etats‐Unis
Ural	Oural
Uruguay	Uruguay
Valencia	Valence
Vancouver Island	Ile de Vancouver
Vatican	Vatican
Venetian blind	store vénitien
Venice	Venise
Venus	Vénus
Victoria	Victoria
Vienna	Vienne
Viennese	viennois
Viennese woman	Viennoise
Vietnam	Viêt‐nam
Vietnamese	vietnamien
Vietnamese woman	Vietnamienne
Visigoth	Visigoth
Vistula	Vistule
Volga	Volga
Volt	volt
Vosges	Vosges
Vulcan	Vulcain
Vulgate	Vulgate
Walachia	Valachie
Wales	Galles
Wallachia	Valachie
Wallonia	Wallonie
Walloon	wallon
Warsaw	Varsovie
Wednesday	mercredi
Welsh	gallois
Welshman	Gallois
West	occident
Western Islands	Hébrides
Westphalia	Westphalie
West German	de l'Allemagne occidentale
West Germany	Allemagne de l'Ouest
Whitsunday	Pentecôte
Woolsey Narrows	défilé Woolsey
Yemen	Yémen
Yemeni	Yéménite
Yemeni woman	Yéménite
Ypres	Ypres
Yugoslav	yougoslave
Yugoslavia	Yougoslavie
Yugoslavian	yougoslave
Yugoslav woman	Yougoslave
Yukon	Yukon
Yukon River	Yukon
Yukon Territory	territoire du Yukon
Zaire	Congo
Zambia	Zambie
Zambian	zambien
Zanzibar	Zanzibar
Zaïre	Zaïre
Zealand	Zélande
Zealander	Zélandais
Zeus	Zeus
Zimbabwe	Zimbabwe
Zulu	Zoulou
... ago	il y a ...
... to	... à
a	à
abacus	abaque
abandon	abdiquer
abandoned	abandonné
abandonment	abandon
abase	abaisser
abasement	abaissement
abase oneself	s'humilier
abashment	embarras
abate	s'abaisser
abatement	abaissement
abattoir	abattoir
abbatial	abbatial
abbess	abbesse
abbey	abbaye
abbot	abbé
abbreviate	abréger
abbreviation	abrégement
abdicate	abdiquer
abdication	abdication
abdomen	abdomen
abdominal	abdominal
abductor	abducteur
aberrant	aberrant
aberration	erreur
abet	agiter
abhor	abhorrer
abhorrence	abomination
abhorrent	abject
abide	attendre
abide by	se conformer
abiding	permanent
ability	aptitude
abiogenesis	abiogenèse
abject	abject
abjection	abjection
abjuration	abjuration
abjure	abjurer
ablative	ablatif
ablaze	ardant
able	apte à
abnegate	agir avec abnégation
abnegation	abnégation
abnormal	aberrant
abode	domicile
abolish	abolir
abolition	abolition
abolitionist	abolitionniste
abominable	abject
abominate	abhorrer
abomination	abomination
aboriginal	aborigène
abort	faireavorter
abortion	avortement
abortionist	avorteur
abortive	inutile
abound	abonder
about‐face	transformation
about	concernant
above‐board	honnête
above	au‐dessus de
above all	surtout
abrasive	perçant
abridge	limiter
abridgement	abrégé
abroad	à l'étranger
abrogate	abolir
abrogation	abolition
abrupt	abrupt
abruptly	abruptement
abscess	abcès
abscissa	abscisse
abscond	s'enfuir
abseil	descendre en rappel
absence	absence
absence of mind	distraction
absent	absent
absent oneself	s'absenter
absent onself	partir
absinth	absinthe
absolute	absolu
absolutely	absolument
absolute power	autocratie
absolute rule	autocratie
absolute ruler	autocrate
absolution	absolution
absolutism	absolutisme
absolve	absoudre
absorb	disposer
absorbed in	plongé dans
absorbent	absorbant
absorbing	passionnant
absorption	absorption
abstain	s'abstenir
abstain from	s'abstenir de
abstemious	sobre
abstention	abstention
abstinence	abstention
abstract	abstrait
abstraction	abstraction
abstruse	mystérieux
absurd	absurde
absurdity	absurdité
abundance	richesse
abundant	abondant
abundantly	abondamment
abuse	insulter
abut	aboutir
abysmal	affreux
abyss	abîme
acacia	acacia
academic	académique
academician	académicien
academy	académie
acanthus	acanthe
accede	adhérer
accelerate	accélerer
acceleration	accélération
accelerative	accélérateur
accelerator	accélérateur
accelerator pedal	accélérateur
accent	accentuer
accentuate	accentuer
accent mark	accent
accept	accepter
acceptable	acceptable
acceptance	abord
accepted	accepté
acceptor	accepteur
access	accès
accessible	abordable
accession	acquisition
accessory	accessoire
accidence	hasard
accident‐prone	enclin aux accidents
accident	accident
accidental	accidentel
accident risk	risque d'accident
acclaim	acclamer
acclamation	acclamation
acclimate	s'acclimater
acclimatization	acclimatation
acclimatize	s'acclimater
acclivity	côte
accolade	accolade
accommodating	accommodant
accommodation	accomodation
accommodate	adapter
accommodate oneself	s'adapter
accompaniment	accompagnement
accompanist	accompagnateur
accompany	accompagner
accomplish	aboutir
accomplished	compétent
accomplishment	ouvrage
accord	être d'accord
accordance	accord
accordingly	ensuite
according as	d'après
according to	selon
accordion	accordéon
accordionist	accordéoniste
accost	aborder
account	facture
accountable	correspondant
account for	expliquer
accredit	accréditer
accretion	accroissement
accrue	provenir
accumulate	accumuler
accumulation	accumulation
accumulator	accu
accuracy	exactitude
accurate	ponctuel
accusal	accusation
accusation	accusation
accusative	accusatif
accuse	accuser
accused	accusé
accuser	accusateur
accustom	avoir coutume
accustomed	accoutumé
accustom oneself	s'accoutumer
ace	as
acerbic	acerbe
acerbity	acuité
acetate	acétate
acetone	acétone
acetous	acide
acetylene	acétylène
ache	douleur
achieve	acquérir
achievement	action
achrostic	acrostiche
acid	acerbe
acidify	acidifier
acidity	acidité
acidness	acidité
ack‐ack	artillerie anti‐aérienne
acknowledge	croire
acknowledgement	reconnaissance
acme	apogée
acne	acné
acolyte	adepte
aconite	aconit
acorn	gland
acoustic	acoustique
acoustics	acoustique
acquaint	apprendre à
acquaintance	abord
acquiesce	se résigner
acquiescence	abandon
acquire	acquérir
acquired	appris
acquirement	acquisition
acquisition	acquisition
acquisitive	avide
acquit	absoudre
acquittal	réglement
acre	acre
acrid	acerbe
acrimonious	perçant
acrimony	acuité
acrobat	acrobate
acrobatic	acrobatique
acrobatics	acrobaties
across	en largeur
across from	contre
act	agir
actinium	actinie
action	activité
activate	activer
active	actif
activity	activité
actor	acteur
actress	actrice
actual	effectif
actuality	réalité
actually	en réalité
actuate	mouvoir
act as agent	procurer
act as a middleman	faire le courtage
act crazy	être fou
act for	représenter
act of grace	amnistie
act on	agir selon
act out	réaliser
act upon	agir selon
acuity	acuité
acupuncture	acupuncture
acute	aigu
ad‐lib	improviser
ad	annonce
adage	proverbe
adagio	adagio
adapt	adapter
adaptation	adaptation
adapted	adapté
adaptor	adapteur
adapt oneself	s'adapter
add	additionner
adder	couleuvre
addiction	lubie
addition	addition
additional	additionnel
addled	idiot
address	adresser
addressee	destinataire
addressing machine	machine à adresser
address list	annuaire
add up	additionner
adept	adepte
adequate	adéquate
adhere	concorder
adherence	attachement
adherent	adepte
adherents	adhérents
adhesion	adhésion
adhesive	adhésif
adieu	adieu
adjacent	adjacent
adjectival	adjectif
adjective	adjectif
adjoin	aboutir
adjoining	adjacent
adjourn	ajourner
adjournment	sursis
adjudication	jugement
adjunct	addition
adjust	adapter
adjustable wrench	clef
adjustment	adaptation
adjutant	adjudant
administer	administrer
administration	administration
administrative	administratif
administrator	administrateur
admirable	admirable
admiral	amiral
admiration	admiration
admire	admirer
admirer	admiratrice
admiring	admiratif
admission	abord
admit	admettre
admittance	abord
admixture	mélange
admonish	admonester
admonition	observation
adolescence	adolescence
adolescent	adolescent
adopt	adopter
adopted	adoptif
adoption	adoption
adoptive	adoptif
adoptive child	fils adoptif
adorable	adorable
adoration	adoration
adore	adorer
adored one	adorée
adorer	adoratrice
adorn	décorer
adornment	ornament
adrenaline	adrénaline
adroit	adroit
adult	majeur
adulterate	diluer
adulterer	adultère
adulteress	adultère
adulterous	adultère
adultery	adultère
advance	s'approcher
advancement	progrès
advantage	avantage
advantageous	avantageux
advent	avent
adventitious	accessoire
adventure	aventure
adventurous	périlleux
adverb	adverbe
adverbial	adverbial
adversary	adversaire
adverse	contradictoire
adversity	abaissement
advert	surveiller
advertence	attention
advertency	attention
advertise	annoncer
advertisement	annonce
advertiser	messager
advice	avis
advise	conseiller
advocate	avocat
ad infinitum	infiniment
aerate	aérer
aerial	aérien
aerodrome	aérodrome
aerodynamic	aérodynamique
aerodynamics	aérodynamique
aerogramme	aérogramme
aerolite	aérolithe
aeronaut	aéronaute
aeronautics	aéronautique
aeroplane	aéroplane
aerosol	aérosol
affable	affable
affair	affaire
affect	affecter
affectation	affectation
affected	affecté
affecting	attendrissant
affection	affection
affectionate	amoureux
affiliate	adhérer
affiliation	filiale
affinity	affinité
affirm	assurer
affirmation	promesse
affirmative	affirmatif
affix	affixe
afflict	affliger
affliction	désolation
affluence	richesse
affluent	affluent
afford	permettre
affray	bagarre
afire	ardant
aflame	ardant
afraid	timide
afresh	de nouveau
after	derrière
afternoon	après‐midi
afterwards	après
again	de nouveau
against	contre
agape	agape
agar‐agar	agar‐agar
agar	agar‐agar
agate	agate
agave	agave
age	âge
aged	âgé
agency	agence
agenda	agenda
agent	agent
agglomerate	aggloméré
agglutinate	agglutiner
aggrandize	accroître
aggrandizement	accroissement
aggravate	agacer
aggravating	agaçant
aggregate	agrégat
aggression	agression
aggressive	agressif
aggressor	attaquant
aggro	agression
aghast	stupéfait
agile	agile
agitate	agiter
agitated	agité
agitation	agitation
aglow	ardant
agnostic	agnostique
agog	curieux
agonize	agoniser
agony	abois
agoraphobia	agoraphobie
agrarian	agrarien
agree	être d'accord
agreeable	agréable
agreeably	agréablement
agreed	çava
agreement	accord
agricultural	agrarien
agricultural exhibition	exposition agricole
agricultural product	produit agricole
agricultural school	école d'agriculture
agriculture	agriculture
agriculturist	agronome
agronomics	agriculture
ague	fièvre
ah	ah
aha	ah
ahead	auparavant
aid	adjoint
aide‐de‐camp	adjudant
ailment	infirmité
aim	avoir pour but
air‐balloon	aérostat
air‐defence	défense anti‐aérienne
air‐filter	filtre à air
air‐fleet	flotte aérienne
air‐grid	grille d'aération
air‐gun	fusil à air comprimé
air‐mail stamp	timbre de poste aérienne
air‐pollution	pollution atmosphérique
air‐pressure	pression atmosphérique
air‐resistance	résistance à l'air
air‐squadron	escadron aérien
air‐valve	valve
air	air
aircraft	aéronef
airdrome	aérodrome
airfield	aérodrome
airless	étouffant
airlift	pont aérien
airline‐pilot	pilote de ligne
airmail	poste aérienne
airman	aviateur
airplane	aéroplane
airport	aéroport
airship	dirigeable
airsick	ayant le mal de l'air
airsickness	mal de l'air
airway	route aérienne
airy‐fairy	malin
air bridge	pont aérien
air conditioned	climatisé
air cushion	coussin d'air
air gun	fusil à air comprimé
air hostess	hôtesse de l'air
air letter	aérogramme
air out	aérer
alacrity	avidité
alarm	alarmer
alarmclock	réveil
alas	malheureusement
albatross	albatros
albino	albino
album	album
albumen	albumen
alburnum	aubier
alchemist	alchimiste
alchemy	alchimie
alcohol	alcool
alcoholic	alcoolique
alcoholism	alcoolisme
alcove	alcôve
aldehyde	aldéhyde
alder	aulne
alderman	adjoint au maire
ale	bière
alert	actif
alga	algue
algebra	algèbre
algebraic	algébrique
alibi	alibi
alien	abject
alike	pareil
alimony	pension alimentaire
alive	vivant
alkali	alcali
alkaline	alcalin
all	tout
allegedly	il paraît que
allegoric	allégorique
allegory	allégorie
allergic	allergique
allergy	allergie
alley	ruelle
alliance	alliance
alligator	alligator
alliteration	allitération
allow	laisser
alloy	alliage
allude	faire allusion
all about	partout
all of a sudden	soudainement
all of it	toutes les fois
all over again	de nouveau
all the	tout le
all the time	dans l'intervalle
all the while	dans l'intervalle
almanac	almanach
almond	amande
almost	presque
alms	aumône
aloe	aloès
alone	seul
alpaca	alpaga
alpha	alpha
alphabet	abc
alphabetical	alphabétique
alpine	alpestre
already	déjà
also	aussi
altar	autel
alteration	transformation
alternate	alterner
alternative	alternative
although	quoique
altitude	altitude
altogether	tout
altruism	altruisme
altruist	altruiste
altruistic	altruiste
alum	alun
aluminium	aluminium
aluminum	aluminium
always	en tous temps
always harp on one string	revenir toujours sur la même chapitre
always harp on the same string	revenir toujours sur la même chapitre
amaranthus	amarante
amass	entasser
amateur	amateur
amaze	étonner
ambassador	ambassadrice
amber	ambre
ambiguous	ambigu
ambition	ambition
ambitious	ambitieux
ambivalence	ambivalence
ambrosia	ambroisie
ambulance	ambulance
amen	ainsi soit‐il
amethyst	améthyste
amidst	au milieu de
ammonia	ammoniaque
ammunition	munitions
amnesty	amnistie
amoeba	amibe
among	au milieu de
amorphous	amorphe
amount	nombre
ampersand	perluète
amphetamine	amphétamine
amphibian	amphibie
amphitheatre	amphitéâtre
amphora	amphore
ample	ample
amplitude	amplitude
amputate	amputer
amputation	amputation
ampère	ampère
amuck	amok
amulet	amulette
amuse	amuser
amusement	amusement
amusing	amusant
an	un
anabaptism	anabaptisme
anachronism	anachronisme
anaconda	anaconda
anaemia	anémie
anaemic	anémique
anaesthesia	anesthésie
anaesthesist	anesthésiste
anagram	anagramme
anal	anal
analogous	analogue
analogy	analogie
analyse	analyser
analysis	analyse
analyst	analyste
analytical chemist	analyste
anapaest	anapeste
anarchic	anarchique
anarchical	anarchique
anarchism	anarchisme
anarchist	anarchique
anarchy	anarchie
anathema	anathème
anatomical	anatomique
anatomist	anatomiste
anatomy	anatomie
anchor	ancre
anchovy	anchois
ancient	antique
and	et
and ... as well	d'ailleurs
and also	d'ailleurs
anecdotal	anecdotique
anecdote	anecdote
anemone	anémone
anew	de nouveau
angel	ange
angelic	angélique
angelica	angélique
angina	angine
angle	angle
angler	pêcheur à la ligne
anguish	angoisse
angular	anguleux
aniline	aniline
animal	animal
animate	animer
ankle	cheville
anniversary	anniversaire
annotation	note
announce	annoncer
announcement	faire‐part
announcer	speaker
annoy	agacer
annoyance	désolation
annual	annuel
annul	abroger
anode	anode
anoint	enduire
anonymity	anonymat
anonymous	anonyme
anonymous writer	inconnu
another	autre
another man	autrui
answer	correspondre à
ant	fourmi
antecedent	précédent
antelope	antilope
antenna	antenne
anthem	hymne
anthology	anthologie
anthracite	anthracite
anthropologist	anthropologiste
anthropology	anthropologie
anti‐Semite	antisémite
anti‐Semitic	antisémitique
anti‐Semitism	antisémitisme
anti‐aircraft defence	défense anti‐aérienne
anti‐aircraft defences	défense anti‐aérienne
anti‐aircraft guns	artillerie anti‐aérienne
anti‐tank gun	bazooka
antibiotic	antibiotique
antibody	anticorps
anticipate	anticiper
anticipation	anticipation
antidote	antidote
antifreeze	antigel
antimony	antimoine
antipode	antipode
antique	antique
antiseptic	antiseptique
antisocial	antisocial
antithesis	antithèse
anus	anus
anvil	enclume
anxiety	anxiété
anxious	agité
any	un
anybody	un
anything	quelque chose
anyway	de façon ou d'autre
anywhere	quelque part
aorta	aorta
apache	Apache
apart	particulier
apartheid	apartheid
apartment	appartement
apart from	en outre
apathetic	apathique
apathy	abattement
ape	singe
aperture	orifice
aphasia	aphasie
aphorism	aphorisme
apiarist	apiculteur
apiary	rucher
aplomb	aplomb
apocalyptic	apocalyptique
apocryphal	apocryphe
apology	apologie
apoplectic fit	apoplexie
apostate	apostat
apostle	apôtre
apostleship	apostolat
apostolate	apostolat
apostolic	apostolique
apostrophe	apostrophe
apotheosis	apothéose
appal	abasourdir
apparatus	appareil
apparently	évidemment
appeal	faire appel
appeal to	invoquer
appear	paraître
appearance	air
appear to be	paraître
appease	abattre
appellation	nom
appendicitis	appendicite
appendix	appendice
appetite	appétit
applaud	acclamer
apple‐tree	pommier
apple	pomme
apply	appliquer
apply to	recourir à
appointment	rencontre
appointment book	agenda
appraise	apprécier
appreciate	apprécier
apprehension	arrestation
approach	aborder
approachable	abordable
appropriate	convenable
appropriately	proprement
approval	acclamation
approve	approuver
approximately	à peu près
apricot‐tree	abricotier
apricot	abricot
apron	tablier
aptitude	aptitude
aquarium	aquarium
aquatic	aquatique
aqueduct	aqueduc
aquiline nose	nez aquilin
aquittal	acquittement
arabesque	arabesque
arbiter	arbitre
arbitrary	arbitraire
arbitrator	arbitre
arbor	tonnelle
arbutus	arbousier
arbutus fruit	arbouse
arc	arc
archaeological	archéologique
archaeologist	archéologue
archaeology	archéologie
archaism	archaïsme
archangel	archange
archbishop	archevêque
archduchy	archiduché
archduke	archiduc
archipelago	archipel
architect	architecte
architectonic	architectonique
architectural	architectonique
architecture	architecture
archivist	archiviste
ardent	ardant
are	are
area	aire
arena	arène
argon	argon
argue	se disputer
argument	argument
aria	air de musique
arise	se soulever
aristocracy	aristocratie
aristocrat	aristo
aristocratic	aristocratique
arithmetic	arithmétique
arm‐rest	accotoir
arm	armer
armchair	fauteuil
armour	armure
armoury	arsenal
armpit	aisselle
army	armée
army chaplain	aumônier
arnica	arnica
aroma	arôme
aromatic	aromatique
around	autour de
arouse	réveiller
arrack	arack
arrange	accommoder
arrangement	construction
arrest	arrêter
arrival	arrivage
arrivals	fourniture
arrive	arriver
arrogant	arrogant
arrow	flêche
arse	anus
arsenal	arsenal
arsenic	arsenic
art	art
arteriosclerosis	artériosclérose
artery	artère
artesian	artésien
arthritis	arthrite
artichoke	artichaut
article	article
article of dress	habit
artificial	affecté
artillery	artillerie
artilleryman	artilleur
artisan	artisan
artist	artiste
arum	arum
as	comme
asbestos	asbeste
ascend	se soulever
ascertain	constater
ash	cendre
ashtray	cendrier
ask	demander
ask for	demander
ask forgiveness	s'excuser
ask for alms	demander l'aumône
ask for an alms	demander l'aumône
ask for charity	demander l'aumône
asparagus	asperge
aspect	air
aspen	tremble
asphalt	asphalter
asphodel	asphodèle
aspiration	souhait
aspire	aspirer
aspire to	aspirer
aspirin	aspirine
ass	âne
assailant	attaquant
assault	assaillir
assemblage	réunion
assemble	réunir
assembly	accumulation
assent	affirmer
assert	affirmer
assertion	assertion
asset	acquisition
assets	actif
assign	adjuger
assigned job	devoir
assimilate	assimiler
assimilation	assimilation
assist	aider
assistant	adjoint
associate	s'accoupler
association	association
assure	assurer
aster	aster
asterisk	astérisque
asteroid	astéroïde
asthma	asthme
asthmatic	asthmatique
astringent	astringent
astrologer	astrologue
astrology	astrologie
astronaut	astronaute
astronomer	astronome
astronomic	astronomique
astronomical	astronomique
astronomy	astronomie
astute	avisé
asylum	abri
asymmetric	asymétrique
asymmetrical	asymétrique
as far as I am concerned	quant à moi
as for the rest	d'ailleurs
as if	comme
as is being said	il paraît que
as regards	concernant
as though	comme
as to	concernant
as well as	d'ailleurs
as you wish	à volonté
at	à
atavism	atavisme
atelier	atelier
atheism	athéisme
atheist	athée
athlete	athlète
athletic	athlétique
athletics	athlétisme
atlas	atlas
atmosphere	atmosphère
atmospheric	atmosphèrique
atoll	atoll
atom	atome
atomic	atomique
atom bomb	bombe atomique
atpersand	colimaçon
atrocity	abomination
atrophy	atrophie
attach	appliquer
attachement	dévouement
attachment	attachement
attack	assaillir
attacker	attaquant
attain	acquérir
attempt	se démener
attend	soigner
attention	attention
attentive	attentif
attentively	attentivement
attest	attester
attic	mansarde
attitude	attitude
attitudinize	agir avec affectation
attitudinizer	faiseur d'embarras
attract	allécher
attraction	appât
attractive	affriolant
attribute	attribut
attune	adapter
at all	n'importe
at a strech	de suite
at first	d'abord
at last	enfin
at least	au moins
at long last	enfin
at most	tout au plus
at once	aussitôt
at present	maintenant
at some time	jadis
at that place	là
at the outset	d'abord
at the right time	à temps
at the same time	en même temps
at will	à volonté
aubade	aubade
aubergine	aubergine
auction	vente aux enchères
audacious	audacieux
audacity	audace
audience	audience
audit	surveiller
auditory	auditorium
augment	accroître
aunt	tante
aura	aura
aureole	auréole
aurochs	aurochs
aurora	aurore
autarky	autarcie
authentic	authentique
author	auteur
authorative	autoritaire
authority	autorité
authorization	autorisation
authorize	autoriser
autism	autisme
autistic	autistique
autobiographical	autobiographique
autobiography	autobiographie
autobus	autobus
autocracy	autocratie
autocrat	autocrate
autocratic	autocratique
autodidact	autodidacte
autogenous	autogène
automate	automatiser
automatic	automatique
automatically	automatiquement
automoton	automate
autonomic	autonome
autonomous	autonome
autonomy	autonomie
autopsy	autopsie
autumn	automnal
auxilary	auxiliaire
avalanche	avalanche
avant‐garde	avant‐garde
avarice	avarice
avaricious	avare
avenge	venger
avenge oneself	venger
avenue	allée
average	intermédiaire
aversion	antipathie
aviation	aviation
aviator	aviateur
avidity	avidité
avoid	éviter
await	attendre
awaken	réveiller
aware	conscient
awareness	connaissance
away	loin
awful	abject
awfully	affreusement
awkward	maladroit
axe	hache
axiom	axiome
axis	axe
axle	axe
azalea	azalée
azimuth	azimut
a few	quelques uns
a little	une certaine quantité
a long time	longtemps
a lot	beaucoup
a lot of	beaucoup
baboon	babouin
baby	bébé
babysitter	baby‐sitter
baby's bottle	biberon
baby's comforter	sucette
bachelor	célibataire
back	dos
background	arrière‐plan
backpack	sac tyrolien
backside	derrière
back of the neck	nuque
bacon	lard
bacterium	bactérie
bad	mal
badge	insigne
badly	mal
bagasse	bagasse
baggage	bagage
bairn	enfant
bake	faire cuire au four
bakelite	bakélite
baker	boulanger
bakery	boulangerie
balalaika	balalaïka
balance	reliquat
balcony	balcon
bald	chauve
baldachin	baldaquin
ball‐bearing	globe
ball‐frame	abaque
ball‐point pen	stylo à bille
ball	bal
ballad	ballade
ballade	ballade
ballast	ballast
ballerina	ballerine
ballet	ballet
ballet dancer	ballerine
ballet girl	ballerine
ballistics	balistique
balloon	aérostat
ballpoint	stylo à bille
ballpoint pen	stylo à bille
balm	baume
balsam	balsamine
balustrade	balustrade
bamboo	bambou
ban	anathème
banana‐plant	bananier
banana	banane
banana plant	bananier
band	bande
bandage	bandage
bandit	bandit
banisters	balustrade
banjo	banjo
bank	banque
banker	banquier
bankruptcy	banqueroute
bank clerk	banquier
bank manager	banquier
bank official	banquier
banner	drapeau
banquet	banqueter
banyan	banian
baobab	baobab
baptism	baptême
baptist	baptiste
baptistery	baptistère
baptize	baptiser
bar	barrer
barbarian	barbare
barbaric	barbare
barbarism	barbarisme
barbarity	barbarie
barbarousness	barbarie
barbel	barbeau
barber	barbier
bard	barde
bare	nu
barely	à peine
bargain	marchander
barge	barge
baritone	baryton
barium	baryum
bark	écorce
barley	orge
barman	barman
barn	baraque
barometer	baromètre
baron	baron
baroness	baronne
barony	baronnie
baroque	baroque
barque	barque
barrack	baraque
barracks	caserne
barrel	fût
barricade	barricader
barrier	barrière
barrister‐at‐law	avocat
barrister	avocat
bartender	barman
bas‐relief	bas‐relief
basalt	basalte
base	baser
baseball	base‐ball
basement	cave
basic	basique
basil	basilic
basilica	basilique
basin	bol
basket	corbeille
basketball	basket‐ball
bass	perche
bast	liber
bastard	bâtard
bastion	bastion
bat	chauve‐souris
bath	baignoire
bathe	baigner
bathing‐suit	maillot de bain
bathing box	cabine de bain
bathing suit	maillot de bain
bathroom	piscine
batik	batiker
batiste	batiste
baton	bâton
battery	accu
battle	bataille
battlefront	front
bauxite	bauxite
bawdy	bordel
bay	aboyer
bayonet	baïonnette
bazaar	bazar
bazooka	bazooka
beach	plage
bead	perle
beak	bec
beam	rayon
bean	fève
bear	faire naître
beard	barbe
bearded	barbu
bearer share	action au porteur
bear witness of	attester
beast	animal
beat	battre
beat off	débattre
beautiful	beau
beautiful woman	beauté
beauty	beauté
beaver	castor
because	attendu que
because of	à cause de
become	devenir
become dull	s'abêtir
becoming	convenable
bed	planche
bedbug	punaise
bedroom	chambre à coucher
bee‐keeper	apiculteur
bee‐keeping	apiculture
bee‐master	apiculteur
bee	abeille
beech	hêtre
beef	bœuf
beefsteak	bifteck
beehive	ruche
beer	bière
beeswax	cire d'abeilles
beet	betterave
beetle	scarabée
befit	être décent
befog	brouiller
before	avant
beg	mendier
beget	engendrer
beggar	mendiant
begin	aborder
beginning	début
begonia	bégonia
begrudge	ménager
beguinage	béguinage
beguine	béguine
behave	se conduire
behavior	procédé
behaviour	procédé
behind	derrière
behold	voici
beige	beige
belch	roter
belief	conviction
believe	croire
bell	clochette
belladonna	belladone
belles‐lettres	belles‐lettres
belly	abdomen
belong to	appartenir
below	sous
belt	ceinture
bench	banc
bend	courber
beneath	sous
benefit	avantage
bent	courbe
benzene	benzène
berry	baie
beryllium	béryllium
beseech	implorer
beside	à
besides	d'ailleurs
besiege	assièger
bet	parier
betray	trahir
betrothal	accordailles
better	meilleur
between	au milieu de
beverage	boisson
bevy	bande
bewitch	ensorceler
beyond	plus loin
be able to	pouvoir
be about	circuler
be acquainted with	connaître
be addicted	être accro
be adrift	dériver
be advised	s'informer
be afraid of	avoir peur
be alive	vivre
be angry	être en colère
be appropriate	convenir
be ashamed	avoir honte
be asleep	dormir
be as slippery as an eel	échapper comme une anguille
be at loggerheads	se bagarrer
be bankrupt	faire banqueroute
be bold	oser
be bored	s'ennuyer
be born	naître
be called	s'appeler
be delirious	délirer
be detained	rester en arrière
be different	différer
be effective	agir
be fitting	être décent
be found	se trouver
be glad	être joyeux
be hungry	avoir faim
be inclined	incliner
be indignant	s'indigner
be interested	s'intéresser
be in labour	accoucher
be in the habit of	avoir coutume
be kept in	rester en arrière
be lacking	manquer
be late	tarder
be lenient with	être indulgent
be located	se trouver
be lost	se perdre
be married	se marier
be missing	manquer
be near death	agoniser
be next to	aboutir
be obstinate	s'obstiner
be on duty	être de service
be present	assister
be proud	triompher
be quiet	se taire
be similar	rejoindre
be situated	être situé
be sorry about	regretter
be stubborn	s'obstiner
be succesful	prospérer
be suitable	convenir
be thirsty	avoir soif
be tired of something	s'ennuyer
be unfaithful	tromper
be unfaithful to	tromper
be vacant	être vacant
be washed ashore	arriver en flottant
be willing to	vouloir
be worth	valoir
be worthy of	mériter
bicycle	bécane
bid	offrir
big	grand
bike	bécane
bikini	bikini
bile	amer
bilk	mystifier
bill‐board	panneau d'affichage
bill	bec
bind	relier
binding	bande
bindweed	liseron
binocular	lunette
binoculars	jumelles
birch	bouleau
bird	oiseau
birth	naissance
birthday	anniversaire
biscuit	biscuit
bishop	évêque
bison	bison
bit	fragment
bite	mordre
bitter	âcre
bitterness	âcreté
bizarre	bizarre
black	brun
blackberry	mûre sauvage
blackberry bush	mûre sauvage
blackbird	merle
bladder	bulle
blade	lame
blame	gronder
bland	doucereux
blank	blanc
blanket	couverture
blaspheme	blasphémer
bleak	désagréable
bleat	bêler
blend	mélanger
bless	bénir
blind	aveugle
blister	ampoule
block	se mettre en travers
blockade	se mettre en travers
blond	blond
blood	sang
bloom	fleur
blot	tache
blotter	papier buvard
blotting paper	papier buvard
blouse	blouse
blow	bataille
blow up	aggraver
blue	bleu
blueberry	myrtille
blush	rougir
blushing	rouge
boa	boa
boar	verrat
board	panneau
boarding house	pension
boarding school	pension
board of directors	commandement
boast	faire le malin
boat	barque
bobbin	bobine
body	corps
boil	bouillir
boiler	chaudron
bold	audacieux
boldness	audace
bolt	verrouiller
bomb	bombe
bombard	bombarder
bon‐bon	bonbon
bonbon	bonbon
bond	lien
bone	os
bony	osseux
book	livre
bookcase	bibliothèque
bookseller	libraire
bookshop	librairie
bookstore	librairie
boot	botte
border	lisière
bore	forer
boring	maussade
borrow	emprunter
borrow money on	emprunter sur gages
bosom	poitrine
boss	maître
botch	gâcher
both	les deux
bother	déranger
bottle	bouteille
bottom	fond
bough	branche
bouillon	bouillon
boulder	rocher
boulevard	boulevard
boundary	frontière
bouquet	bouquet
boutique	boutique
bovine	bœuf
bovine animal	bœuf
bow	arc
bowl	bassin
box‐room	réserve
box	boxer
boy	garçon
boyscout	reconnaissance
boy scout	reconnaissance
bra	soutien‐gorge
brace	parenthèse
braces	bretelles
bracket	parenthèse
brag	faire le malin
braid	natter
brain	cerveau
brake	freiner
brakedown	panne
bramble	mûre sauvage
branch	branche
brandish	agiter
brandy	eau‐de‐vie
brass	laiton
brat	bambin
brave	brave
breach	brèche
bread	pain
break	pause
breakable	fragile
breakfast	petit déjeuner
break down	s'abîmer
break down upon	s'adresser à
break into	entamer
breast	poitrine
breath	haleine
breathe	respirer
breed	élever
bribe	corrompre
brick	brique
bride	accordée
bridge	pont
bridle	réprimer
brief	court
briefcase	collection à consulter
briefs	slip
bright	luisant
brilliant	luisant
brim	bord
brimstone	soufre
bring	amener
bring away	entraîner
bring close together	approcher
bring into agreement	mettre d'accord
bring near to	rapprocher
bring up	éduquer
brinjal	aubergine
brink	bord
brisk	actif
bristly	ébouriffé
brittle	fragile
broach	forer
broad	ample
broker	représentant
bronze	airain
brooklet	ruisselet
broom	balai
brothel	bordel
brother	frère
brow	sourcil
brown	brun
brownie	gnome
brush	brosse
brutal	maussade
bubble	bulle
buck‐hare	bouquin
buck‐rabbit	bouquin
buck	bouquin
bucket	seau
buckle	boucle de vêtement
buddy	camarade
buffalo	bison
buffer	pare‐chocs
buffet	bar
buffoon	arlequin
bug	punaise
build	bâtir
builder	bâtisseur
building	construction
build from wood	charpenter
bulb	ampoule
bulk	ampleur
bulky	ample
bull	taureau
bulldozer	bulldozer
bullet	balle
bulletin	bulletin
bumblebee	bourdon
bump	bosse
bumper	pare‐chocs
bumpy	accidenté
bungle	gâcher
bunker	abri
buoy	balise
burdensome	lourd
bureau	bureau
burgomaster	maire
burial	enterrement
burn	brûler
burnt	brûlé
burp	roter
burr	bardane
burst	crever
bus	autobus
bush	arbrisseau
business	affaire
businessman	négociant
business deal	affaire
but	mais
butcher	abattre
butcher's shop	boucherie
butter	beurre
butterfly	papillon
buttock	fesse
buttocks	cul
button	bouton
buy	acheter
buyer	acheteur
buzz	bourdonner
by‐laws	statut
by	à
bye	adieu
byte	byte
by accident	accidentellement
by acclamation	par acclamation
by chance	accidentellement
by heart	par cœur
by marriage	par alliance
by means of	au moyen de
by mistake	abusivement
by now	déjà
by no means	en aucune façon
by tender	à forfait
by the way	à propos
by twos	à deux
cabbage	chou
cabin	cabane
cabinet	armoire
cable	câble
cactus	cactus
cadaver	cadavre
cadger	parasite
cadre	cadre
caesium	césium
café	café
cage	cage
cake	gâteau
calamity	fléau
calamus	calame
calcium	calcium
calculate	calculer
calculation	addition
calendar	calendrier
calf	veau
call	nommer
caller	visiteur
call at	faire escale à
call at ...'s house	passer chez
call box	cabine téléphonique
call on	passer chez
calm	calme
calmness	repos
cambric	batiste
camel	chameau
camera	caméra
campaign	campagne
camping ground	camp
camping site	camp
camp of tents	camp
canal	canal
canary	canari
cancel	abroger
cancer	cancer
candidate	candidat
candle	bougie
candy	friandise
cane	bâton
canker	cancer
cannon	canon
canopy	baldaquin
cap	casquette
capable	apte à
cape	cap
caper	gambader
capital	capital
capital letter	majuscule
caprice	caprice
captain	capitaine
capture	attraper
car	auto
carbon	carbone
card	carte
cardboard	carton
cardiac	cordial
care	avoir soin de
careful	prudent
careless	négligent
carelessness	négligence
caress	caresser
caressing	tendre
care about	se soucier de
care for	guérir
carnation	œillet
carp	carpe
carpet	tapis
carp at	chicaner
carriage	wagon
carrot	carotte
carry	porter
carry away	entraîner
cart	char
carve	buriner
case	affaire
cashier	trésorier
cashier's stand	caisse
casserole	casserole
cassette	cassette
cast	fondre
castle	château
cast off	précipiter
cat	mégère
catarrh	rhume
catastrophe	catastrophe
catch	s'allumer
category	catégorie
catering	ravitaillement
caterpillar	chenille
cathedral	cathédrale
cauldron	chaudron
cauliflower	chou‐fleur
cause	faire
cause to take place	causer
caution	alerter
cautious	prudent
cavalier	chevalier
cave	grotte
cavity	creux
caw	croasser
cease	cesser
ceaselessly	continuellement
cedar	cèdre
cede	abandonner
ceiling	plafond
celebrate	célébrer
celebration	fête
celebrity	star
celery	céleri
cell	cachot
cellar	cave
cello	violoncelle
cement	ciment
cemetery	cimetière
censor	censurer
censure	critiquer
centennial	siècle
centipede	myriapode
centre	centre
century	siècle
ceremonious	solennel
ceremony	cérémonie
certain	assuré
certainly	assurément
certainty	assurance
certificate	acte
cession	abandon
chain	chaîne
chair	chaise
chairman	président
chalk	craie
challenge	contester
chamber	chambre
chamois	chamois
champagne	champagne
champion	champion
chance	accidentel
change	changer
change of address	changement d'adresse
channel	canal
chanson	chanson
chaos	chaos
chap	individu
chaperon	accompagnatrice
chaplain	aumônier
chapter	chapitre
character	caractère
charge	accusation
chariot	char
charitable	sensible
charity	aumône
charlatan	charlatan
charm	amulette
charming	charmant
chase	amener à
chase away	renvoyer
chasm	abîme
chaste	chaste
chat	babil
chatter	babiller
chatterbox	babillard
chauffeur	chauffeur
cheat	tricher
cheated	déçu
check	réprimer
check up on	surveiller
cheek	joue
cheerful	gai
cheers	à la vôtre
cheese	fromage
chef	chef
chemist	apothicaire
chemistry	chimie
chemist's shop	pharmacie
cheque	chèque
cherry‐tree	cerisier
cherry	cerise
chess	échec
chest	poitrine
chestnut‐tree	châtaignier
chestnut	châtaigne
chew	mâcher
chewing‐gum	chewing‐gum
chew the cud	ruminer
chick	poussin
chicken	poulet
chief	dominant
chiefly	principalement
child	enfant
childbed	lit d'accouchement
chilly	froid
chimera	chimère
chin	menton
chirp	gazouiller
chisel	buriner
chive	ciboulette
chlorine	chlore
chocolate	chocolat
choice	choix
choke	étouffer
cholera	choléra
choose	adopter
chop	hacher
chord	accord
chorus	chœur
chrestomathy	anthologie
christen	baptiser
christening	baptême
chromium	chrome
chuck	caresser
chunk	boule
chunk of wood	bûche
church‐building	église
church	église
churn	baratter
cider	cidre
cigar	cigare
cigarette	cigarette
cinder	cendre
cinema	cinéma
cipher	chiffre
circle	cercle
circular	circulaire
circulate	circuler
circulation	circulation
circumflex	accent circonflexe
circumstance	circonstance
circumstances	situation
circumvent	circuler
circus	cirque
cistern	citerne
citation	citation
cite	citer
citizen	citoyen
city	cité
city hall	hôtel de ville
civil	civil
civilian	civil
claim	aspirer à
clamp	parenthèse
clap	applaudir
clarify	développer
clarion	clairon
clasp	agrafer
class	classe
classic	classique
classical	classique
claw	griffe
clay	argile
clean	pur
cleanliness	propreté
cleanly cut	net
cleanse	affinier
clear	clair
clergyman	abbé
clever	adroit
click	claquer
client	acheteur
cliff	falaise
climate	climat
climb	gravir
climber	alpiniste
clip	couper avec des ciseaux
cloak	manteau
cloakroom	vestiaire
clock	horloge
clod	boule
clog	boucher
close	fermer
closet	armoire
cloth	linge
clothe	habiller
clothes	vêtements
clothing	vêtements
cloud	brouiller
clown	clown
club	club
cluster	grappe
clutch	agripper
co‐	ensemble
coach	entraîner
coal	charbon
coarse	grossier
coast	bord
coat	paletot
cobra	cobra
cock	bitte
cockroach	blatte
cocoa	cacao
cod	morue
coddle	choyer
codfish	morue
coffee‐house	café
coffee‐pot	cafetière
coffee	café
coffin	cercueil
cognac	cognac
coherent	cohérent
coil	bobine
coincide	coïncider
coir	chœur
cold	froid
collar	col
colleague	collègue
collect	collectionner
collection	bande
collide with	aborder
collision	choc
colonel	colonel
colonial	colonial
colony	colonie
colossal	énorme
colour‐blind	daltonnien
colour	couleur
columbine	ancolie
column	colonne
comb	peigner
come	provenir
comet	comète
come about	devenir
come across	rencontrer
come back	revenir
come close	s'approcher
come closer	s'approcher
come on	s'approcher
come together	s'accoupler
come to an agreement	se mettre d'accord
come to an end	finir
come to a halt	s'arrêter
comfort	confort
comfortable	confortable
comfortably	agréablement
comforter	sucette
comic	comique
comical	comique
comma	virgule
command	commandement
commence	aborder
commencement	début
commend	glorifier
commerce	commerce
commercial‐at sign	colimaçon
commission	commission
committee	comité
commit adultery	tromper
commit aggression	agresser
commit suicide	se suicider
commodity	article
common	commun
commonplace	banal
commotion	agitation
communicate	communiquer
communication‐cord	frein de secours
communication	communication
communicative	abordable
communion	communion
community	commune
commute	aiguiller
companian	accompagnateur
companion	camarade
company	compagnie
compare	comparer
comparison	comparaison
compartment	domaine
compass	boussole
compassion	apitoiement
compatible	correspondant
compel	imposer
compensate	compenser
compete	concourir
competent	compétent
competition	concours
complain	porter plainte
complaint	accusation
complete	complet
completely	complètement
complexion	teint
complicate	compliquer
compliment	compliment
compose	se résoudre à
composing	montage
composition	composition
composure	repos
comprise	contenir
compulsory	obligatoire
computer	ordinateur
comrade	camarade
conceal	cacher
conceited	frivole
conceive	concevoir
concentrated	dense
concern	importance
concerned	concerné
concerning	concernant
concert	concert
concise	concis
conclude	se résoudre à
conclusion	résultat
concord	accord
concrete	béton
concurrence	accord
condemn	condamner
condition	condition
condom	condom
conduct	guider
conduct oneself	se conduire
cone	pomme de pin
confectioner's	pâtisserie
confectioner's shop	pâtisserie
confess	avouer
confession	aveu
confide	confier
confidence	foi
confine	limiter
confirm	confirmer
confiscate	confisquer
conflagration	incendie
conflict	conflit
conform	concorder
conforming	conforme
confront	affronter
confuse	confondre
confusion	désordre
congenital	inné
congentital	inné
congestion	afflux
congratulate	féliciter
congregate	réunir
congress	congrès
congruent	correspondant
conjecture	conjecturer
connect	allier
connected	cohérent
connection	ligue
connect up	aboucher
conquer	conquérir
conscience	conscience
conscious	conscient
consciousness	connaissance
consecutively	de suite
consent	admettre
consequence	aboutissement
consequently	ensuite
conservation	garde
conserve	conserver
consider	considérer
considerable	considérable
consignee	destinataire
consist	consister
consistency	aboutissement
consistent	cohérent
consist of	être composé de
consolation	consolation
console	consoler
constant	continuel
constantly	continuellement
consternation	stupéfaction
constringent	astringent
construct	bâtir
consulate	consulat
consult	consulter
consume	consommer
consumer	consommateur
contact	s'aboucher avec
contain	contenir
container	bac
contemplate	contempler
contented	content
contention	assertion
contents	contenu
contest	concours
continent	continent
contingent	éventuel
continual	continuel
continually	continuellement
continuation	suite
continue	continuer
continuous	continuel
continuously	continuellement
contort	tordre
contralto	alto
contralto voice	alto
contrary	contradictoire
contribute	contribuer
control	commandement
control oneself	se surveiller
controversy	polémique
convenient	commode
convention	congrès
conversation	conversation
converse	intervenir
conversion	transformation
convert	convertir
conviction	conviction
convince	convaincre
cook	cuire
cookie	biscuit
coop	poulailler
coping	arête
copious	abondant
copper	cuivre
copulation	accouplement
copy	copier
coquettish	coquet
cord	corde
cordial	cordial
core	centre
cork	liège
corkscrew	tire‐bouchon
cormorant	cormoran
corn	maïs
corner	accaparer
cornflower	barbeau
corpse	cadavre
corpulent	épais
correct	corriger
correspond	correspondre
corridor	corridor
corroborate	confirmer
corrugate	onduler
cosmetic powder	poudre
cosmos	cosmos
cost	coûter
costly	cher
costume	complet
cotton‐wool	ouate
cotton	coton
couch‐grass	chiendent
couch	canapé
cougar	puma
cough	tousser
counsel	avocat
counsellor	conseilleur
count	comte
counting‐frame	abaque
countless	incalculable
country	campagne
countryman	paysan
countryside	campagne
count down	retrancher
count in	additionner
couple	couple
coupon	coupon
coupé	compartiment
courage	abattage
courageous	courageux
courgette	courgette
courier	courrier
course	piste
court	faire la cour
courteous	courtois
courtyard	cour
cousin	cousine
cover	couvrir
covetousness	avidité
cow	vache
coward	peureux
cowardice	faiblesse
cower	être accroupi
cow parsnip	berce
coyote	coyote
crab	crabe
crack	craquer
crane	grue
crane's‐bill	géranium
crash into	aborder
crawl	ramper
crayfish	écrevisse
craziness	aberration
crazy	aberrant
creak	grincer
cream	crème
crease	froisser
create	créer
creature	créature
credential	lettre de créance
creep	ramper
cricket	grillon
crime	crime
crippled	infirme
crisis	crise
criticize	critiquer
croak	croasser
crockery set	service
crocodile	crocodile
cross	croiser
crossways	en largeur
cross out	barrer
crouch	être accroupi
crow	corbeau
crowbar	levier
crowd	amas
crown	couronner
crucifix	crucifix
crude	brut
cruel	atroce
cruise	croiser
crumb	miette
crumble	froisser
crush	foule
cry	cri
crystal	cristal
cry down	abaisser
cry out	crier
cube	cube
cubic	cubain
cuckoo	coucou
cucumber	concombre
cuddlesome	tendre
cuddly	tendre
cuff	manchette
cult	culte
cultivate	cultiver
cultivation	culture
culture	culture
cultured	cultivé
cunning	artificieux
cunt	chatte
cup	tasse
cupboard	armoire
cure	guérir
curiosity	curiosité
curious	curieux
curl	coiffer
currant	groseille
currant bush	groseillier
current	actuel
currently	actuellement
curry	panser
curse	blasphémer
curtail	abréger
curtailment	abaissement
curtain	rideau
curved	courbe
cushion	coussin
cuss	blasphémer
custom	coutume
customary	accoutumé
customer	client
customs	douane
cut	faucher
cutlet	côtelette
cut into	entamer
cut off	abattre
cut up	abaisser
cycle	bécane
cyclone	cyclone
cylinder	cylindre
cylinder phonograph	phonographe
cynical	cynique
cypres	cyprès
dad	papa
daddy	papa
daffodil	narcisse
dahlia	dahlia
daily	journalier
daily paper	journal
dainty	aimable
daisy	pâquerette
damage	avarie
dame	demoiselle noble
dampen	abreuver
dance	bal
dandelion	pissenlit
danger	danger
dangerous	dangereux
dare	aventurer
dare to fight	oser attaquer
daring	audacieux
dark‐room	cabinet noir
dark	foncé
darken	foncer
darkness	obscurité
dash‐board	lambris
data	matériau
date	datte
daughter	fille
dawn	aurore
day	jour
daybreak	aube
daydream	rêver éveillé
dazzle	aveugler
dead‐end street	impasse
dead‐nettle	lamier
deadly	meurtrier
deaf	sourd
deaf and dumb	sourd‐muet
deal	dispenser
deal in secondhand goods	vendre d'occasion
deal with	aborder
dear	cher
death	mort
death throes	abois
debate	débat
debauch	bamboucher
debauchery	noce
debit	débit
debris	abattis
debt	dette
decay	abaissement
decayed	caduc
deceive	tricher
deceived	déçu
decent	convenable
decently	convenablement
decide	décider
decision‐making	parti
decision	décision
deck	pont
declaration	déclaration
declaration of policy	programme
declare	déclarer
decline	diminuer
decorate	décorer
decoration	décor
decoy	attirer
decrease	abaissement
decrepit	caduc
dedicate	consacrer
deduce	déduire
deduct	prélever
deem	croire
deep	profond
deer	cerf
defeat	abattre
defecate	aller à la selle
defence	défense
defend	défendre
defendant	accusé
defense	défense
defiantly	en dépit de
defile	col
define	définer
definite	définitif
definitely	absolument
definitive	définitif
defraud	frauder
defy	provoquer
degenerate	s'abâtardir
degree	degré
delay	ajourner
delegate	déléguer
delete	effacer
deliberately	exprès
delicacy	friandise
delicate	délicat
delicious	savoureux
delight	enchanter
delightful	délicieux
delight in	jouir
delirium	transport
deliver	fournir
delivery	remise
delta	delta
demand	abattement
democrat	démocrate
demolish	abaisser
demonstrate	démontrer
demonstration	manifestation
den	nid
denounce	accuser
dense	dense
dentist	dentiste
deny	nier
deny oneself	agir avec abnégation
depart	partir
department	domaine
departure	départ
depend	dépendre
dependent	subordonné
deportment	procédé
deposit	déposer
depress	abattre
depression	crise
deprive	dépouiller
deprive ... of	dépouiller
depth	profondeur
deputy	député
derive	dériver
derrick	grue
descend	s'abaisser
descent	descente
describe	décrire
description	description
descry	s'apercevoir
desert	désert
deserve	mériter
design	dessiner
desire	désirer
desk	pupitre
desolate	morne
despair	désespérer
despise	dédaigner
despite	malgré
dessert	dessert
destine	destiner
destine for	réserver pour
destiny	destination
destroy	abîmer
destruction	annihilation
detachment	commando
detail	détail
detain	réprimer
detention	arrestation
determine	déterminer
develop	entraîner des conséquences
device	appareil
devil	diable
devote	consacrer
devoted	affectueux
dew	rosée
dexterous	adroit
diagram	figure
dial	disque
dialect	dialecte
dialogue	dialogue
diamond	diamant
diarrhoea	diarrhée
dictate	dicter
dictator	dictateur
dictionary	dictionnaire
die	décéder
diet	diète
differ	différer
difference	différence
different	différent
differently	autrement
difficult	difficile
dig	creuser
digest	digérer
digit	chiffre
dignified	digne
dignity	dignité
dig up	abattre
dilapidated	caduc
diligent	appliqué
dim	obscur
dimension	ampleur
diminish	s'abaisser
diminutive	petit
dining‐room	réfectoire
dinner	déjeuner
dip	tremper
diploma	acte
direct	diriger
direction	direction
directions	instruction
directly	debout
director	directeur
dirty	sale
disabled person	infirme
disadvantage	inconvénient
disappear	disparaître
disappearance	disparition
disappoint	tromper
disappointment	déception
disapprove	repousser
disapprove of	repousser
disc	disque
discharge	partir
disciple	disciple
disciples	adhérents
discipline	discipline
discontented	mécontent
discount	rabais
discover	découvrir
discovery	découverte
discrete	discret
discretion	précaution
discuss	débattre
discussion	discussion
disease	infirmité
disembark	débarquer
dish	met
dishevel	ébouriffer
dish cloth	torchon
disintegrate	disperser
diskette	disquette
dislike	antipathie
dismal	banal
dismay	abasourdir
dismiss	licencier
disobedient	désobéissant
disorder	désordre
dispatch	déposer
disperse	dissiper
display	parader
displeased	mécontent
dispose of	vendre
disposition	aptitude
dispute	se disputer
disquiet	brouiller
dissatisfied	mécontent
dissect	sectionner
dissemble	agir en hypocrite
disseminate	parsemer
dissipation	noce
dissolve	résoudre
dissymmetric	asymétrique
distance	distance
distant	loin
distinct	clair
distinction	distinction
distinguish	dégager
distract	distraire
distraction	amusement
distress	attrister
distribute	dispenser
distribution	répandre
district	arrondissement
distrust	se méfier
disturb	déranger
ditch	fossé
dive	plonger
diverse	divers
diversion	amusement
divert	distraire
divide	séparer
divine	divin
diving‐bell	cloche de plongée
divorce	divorce
do	construire
doctor	docteur
document	acte
doe	biche
dog	chien
dogma	dogme
doll	guignol
dollar	dollar
dolphin	dauphin
dome	voûte
domestic	aborigène
domestic animal	domestique
donate	faire cadeau
donkey‐driver	ânier
donkey	âne
don't mention it	cela ne fait rien
door	porte
dossier	dossier
dot	point
double	double
doubt	douter
doubtful	incertain
dough	pâte
dove	colombe
down	duvet
downstairs	dessous
down payment	acompte
dowry	don
dozen	douzaine
do away with	ôter
do something crooked	tricher
do the honours	recevoir officiellement
drag	tirer
dragonfly	libellule
drain	drainer
drake	canard mâle
dram	apéritif
drastic	énergique
draw	allécher
drawer	tiroir
drawers	caleçon
drawing	dessin
draw attention	signaler
draw back	retirer
draw lots	tirer au sort
draw out	répandre
draw up to the table	s'attabler
dreadful	affreux
dream	rêver éveillé
dreary	désert
dress‐coat	habit
dress	panser
dresser	commode
drift	dériver
drill	forer
drink	s'enivrer
drinkable	potable
drink to excess	s'enivrer
drip	goutte
drive	amener à
driver	chauffeur
drive away	renvoyer
drive on	amener à
drive out	répandre
drive shaft	arbre de transmission
drive through	faire accepter
driving axle	arbre de transmission
drizzle	bruine
drizzling rain	bruine
droop	pendre
drop	goutte
drop of water	goutte
drown	noyer
drug	remède
drugstore	pharmacie
drum	tambour
drunk	ivre
drunkenness	ivresse
dry	sec
dual	double
duchy	duché
duck	canard
duenna	accompagnatrice
dues	cotisation
dull	abêtir
dumb	muet
dummy	sucette
dump	verser
dung	excrément
dunning‐letter	lettre de relance
during	durant
dust	poussière
dust rag	torchon
dwarf	nain
dwell	demeurer
dwelling‐place‐residence	domicile
dwelling‐place	domicile
dwelling	demeure
dye	couleur
dynamite	dynamite
dyspepsia	dyspepsie
décor	décor
each	à
eager	avide
eagerness	avidité
eagle	aigle
eaglet	aiglon
ear	oreille
earl	comte
early	hâtif
earmark	destiner
earn	gagner
earnest	sérieux
earn back	rattraper
earth	terre
earthen	terrestre
earthly	terrestre
earthquake	séisme
earthworm	lombric
earth up	butter
easel	établi
easily	facilement
east	est
easy	facile
eat up	dévorer
echo	écho
economy	économie
edelweiss	edelweiss
edge	bord
edging	bord
edit	rédiger
editorial office	rédaction
educate	éduquer
educated	cultivé
education	instruction
eel	anguille
eelworm	anguillule
effect	effet
effort	démarche
egg	œuf
eggfruit	aubergine
eggplant	aubergine
eight	huit
eighteen	dix‐huit
eighty	quatre‐vingts
either ... or	soit ... soit
elastic	élastique
elbow	coude
elder	sureau
elect	adopter
election	choix
electric	électrique
electricity	électricité
electric fan	aérateur
electric plug	bouchon
electric socket	prise de courant
electron	électron
element	élément
elemental	primaire
elementary	primaire
elements	abc
elephant	éléphant
elevator	ascenseur
eleven	onze
eleventh	onzième
elf	lutin
elk	élan
elm	orme
eloquent	éloquent
else	autre
elsewhere	ailleurs
embarrassment	embarras
embassy	ambassade
embellish	embellir
embrace	embrasser
embroider	broder
emerge	paraître
emergency	crise
emigrate	se réfugier
emmet	fourmi
emotion	émotion
emperor	empereur
emphasis	emphase
emphasize	accentuer
empire	empire
employ	embaucher
employee	employé
employment exchange	bourse du travail
empty	vide
enchanter	sorcier
encounter	rencontrer
encourage	inciter
encyclopaedia	encyclopédie
end‐of‐the‐line	terminus
end	cesser
endeavour	se démener
ending	bout
endlessly	infiniment
endorse	virer
endure	continuer
end up	arriver
enemy	ennemi
energy	énergie
engagement	accordailles
engine	locomotive
engineer	ingénieur
engrave	graver
enigma	énigme
enjoy	être joyeux
enjoyable	agréable
enjoy oneself	se réjouir
enlarge	accroître
enlargement	accroissement
enlighten	illuminer
enormous	immense
enough	suffisant
entangle	empêtrer
enter	introduire
entertain	recevoir des visiteurs
entertaining	amusant
entertainment	amusement
enthusiasm	enthousiasme
entice	détourner
entire	entier
entirely	complètement
entrust	charger
entry	inscription
entrée	hors‐d'œuvre
envelope	enveloppe
environment	environnement
environs	abords
envisage	contempler
envy	envier
epoch	époque
equal	égal
equally	de même
equip	équiper
equivalent	équivalent
era	époque
eradicate	arracher
eraser	gomme
erect	fonder
erecting	montage
erotic	érotique
err	se tromper
errand	commission
erroneous	abusif
error	erreur
escape	échapper
escort	accompagnement
especially	surtout
essay	thèse
essential	essentiel
establish	fonder
estate	bien
esteem	apprécier
estimate	apprécier
etc.	etc.
etching	eau‐forte
eternal	éternel
ethos	ambiance
evade	éviter
even	plat
evening	soir
evening dress	habit
evening meal	dîner
event	événement
eventual	éventuel
ever	jadis
everlasting	infini
every	chaque
everybody	chacun
everyday	vulgaire
everyone's	à tout le monde
everything	tout
everywhere	partout
every kind of	tout
every one	chacun
evident	évident
evoke	rappeler
evolve	évoluer
ex‐	ancien
exact	exact
exactitude	exactitude
exactly	à l'heure
examination	examen
examine	examiner
example	exemple
excavate	abattre
exceed	dépasser
excellency	seigneurie
except	dispenser
except for	en outre
excess	excès
exchange	central
excise‐duty	droit de régie
excise	droit de régie
excite	exciter
excite pity	apitoyer
exciting	captivant
exclude	dispenser
exclusively	ne ... que
excommunication	anathème
excrement	excrément
excursion	excursion
excuse	dispenser
excuse me	je vous demande pardon
excuse oneself	s'excuser
execute	exécuter
exempt	dispenser
exercise‐book	cahier
exercise	exercer
exert	pratiquer
exhortation	observation
exile	banni
exist	exister
exit	issue
expect	attendre
expectation	attente
expel	renvoyer
expenses	dépense
expensive	cher
experienced	experimenté
experiment	essai
expert	experimenté
expertness	adresse
expire	finir
explain	expliquer
explode	exploser
exploit	exploiter
exploration	recherche
explore	examiner
express	répandre
expression	locution
expressway	autoroute
extend	ampleur
extension	suffixe
extensive	ample
exterior	aspect
exterminate	exterminer
extinguish	éteindre
extraordinary	extraordinaire
extreme	extrême
extremely	extrêmement
eye	œil
eyebrow	sourcil
eyelid	paupière
fable	fable
fabric	textile
fabricate	fabriquer
face‐ache	névralgie faciale
face	affronter
facile	facile
facilitate	faciliter
faction	parti
factory	fabrique
faculty	faculté
fade	pâlir
failure	banqueroute
faint	faible
fair	bazar
fairly	relativement
fairy	fée
fairy tale	conte
faith	foi
faithful	fidèle
falcon	faucon
fall	s'abattre
fall in love with	tomber amoureux de
falsify	falsifier
fame	renommée
family	famille
famous	célèbre
fan	souffler sur
fanatical	fanatique
fancier	amateur
fancy	imaginer
fantasy	fantaisie
far	loin
fare	aller
farewell	adieu
farm‐	agrarien
farm	bien
farmer	fermier
farmers' union	syndicat agricole
farming	agriculture
fart	péter
farther	plus loin
fascinating	passionnant
fashion	mode
fashionable	actuel
fast	jeûner
fasten	attacher
fat	épais
fate	destination
father	père
fatty	gras
faucet	robinet
favor	grâce
favorite	favori
favour	grâce
favourable	favorable
favourite	favori
façade	façade
fear	angoisse
feast	banqueter
feather	plume
feature	trait
federation	fédération
feed	alimenter
feeding‐bottle	biberon
feel	tâter
feeling	sentiment
feel sorry for	regretter
feldspar	feldspath
fellow‐creature	semblable
fellow‐thinker	ami
fellow	ensemble
felspar	feldspath
female	femelle
female admirer	admiratrice
female adorer	adoratrice
female ambassador	ambassadrice
female cook	cuisinière
female hairdresser	coiffeuse
female journalist	journaliste
female martyr	martyre
female relative	parente
female singer	chanteuse
female tailor	couturière
female teacher	institutrice
female worshipper	adoratrice
fence	barrière
fern	fougère
ferry	bac
fertile	fécond
fertilize	amender
fertilizer	engrais
fervor	ferveur
fervour	ferveur
festival	fête
fetch	amener
fetter	chaîne
fever	fièvre
fiancé	accordé
fiancée	accordée
fiasco	échec
fief	seigneurie
field	champ
field hospital	ambulance
fierce	féroce
fifteen	quinze
fifty	cinquante
fig‐tree	figuier
fig	figue
fight	batailler
figure	chiffre
file	dossier
filing card	fiche
fill	compléter
fill in	compléter
fill up	compléter
film	film
filter	filtrer
filthy	sale
fin	nageoire
finally	enfin
finance	finance
financial year	année financière
find	discerner
find oneself	se trouver
find out	s'informer
fine	beau
finger	doigt
finish	confectionner
finished	prêt
finish off	achever
fir	sapin
fire	partir
fireplace	cheminée
fire off	partir
firing	tir
firm	ferme
first	premier
firstly	au commencement
first aid	secours
first instalment	acompte
first name	prénom
first of all	au commencement
fish	pêcher
fisherman	pêcheur
fishing rod	canne
fist	poing
fit	adapter
fitting	convenable
fitting up	montage
fit out	garnir
fit together	coïncider
five	cinq
fix	adapter
fixed	fixe
fix up	accommoder
fjord	fiord
flag	drapeau
flame	flamber
flapper	adolescente
flare	ondoyer
flare up	ondoyer
flash on	s'allumer
flat‐iron	fer à repasser
flat	appartement
flatter	aduler
flavour	arôme
flax	lin
flea	puce
flee	échapper
fleet	flotte
flesh	chair
flexible	souple
flicker	scintiller
flight	fuite
flight engineer	mécanicien aéronautique
flight mechanic	mécanicien aéronautique
fling	agiter
fling off	précipiter
flint	silex
flirt	conter fleurette
flit	conter fleurette
float	flotter
flock	troupeau
flood	afflux
floor	étage
flounder	se débattre
flour	farine
flow	couler
flower	fleur
flow down	dégager
flow off	dégager
flu	grippe
fluff	duvet
fluid	flot
fluorine	fluor
flute	flûte
flutter	conter fleurette
fly	voler
foam	écume
fog	brouillard
fold	plier
folder	chemise
folk	peuple
follow	agir selon
followers	adhérents
following	adhérents
fondle	caresser
food	nourriture
fool	sot
foolish	abracadabrant
foot	patte
football	foot
for	durant
forbid	interdire
force	faire accepter
forecast	prédire
forefather	ancêtre
forehead	front
foreign	étranger
foreigner	étranger
foresee	prévoir
foreseeable	prévisible
forest	bois
foretell	prédire
foreward	en avant
foreword	préface
forge	forger
forget‐me‐not	myosotis
forget	oublier
forgive	excuser
fork	fourchette
forks, knives and spoons	couvert
form	former
former	précédent
formerly	auparavant
formidable	extraordinaire
formula	formule
formulate	formuler
forsake	abandonner
forswear	abjurer
fortress	bastille
fortunate	heureux
fortunately	heureusement
fortune	fortune
forty	quarante
forum	forum
for ... together	de suite
for a long time	longtemps
for every reason	pour toutes sortes de raisons
for example	par exemple
for instance	par exemple
for no reason	à cause de rien
for sake of	à cause de
for the greater part	pour la plus part
for the most part	pour la plus part
for the reason that	attendu que
for the rest	d'ailleurs
foster‐father	père adoptif
found	fonder
foundation	fondation
fountain‐pen	stylo
fountain	fontaine
fountain pen	stylo
four	quatre
fourteen	quatorze
fourteenth	quatorzième
fourth	quatrième
fowl	poule
fox	renard
foxglove	digitale
fraction	fraction
fracture	fracture
fragile	fragile
fragrant	aromatique
frame	cadre
framework	cadre
francium	francium
freedom	liberté
freemason	franc‐maçon
freeway	autoroute
freeze	geler
freezing cold	gel
frequent	fréquenter
frequently	beaucoup
fresh	frais
friend	amie
friendly	affable
friendship	amitié
fright	anxiété
frighten	redouter
frigid	froid
fringe	bord
frivolous	frivole
frog	grenouille
frolic	malin
frolicsome	malin
frolic about	gambader
from	de
from ... to	... à
front	front
frontage	front
frontier	frontière
frost	gel
froth	battre
fruit‐tree	fruitier
fruit	fruit
fruitful	fruitier
fry	frire
frying‐pan	poêle
frying pan	poêle
fuck	baiser
full‐grown	majeur
full	complet
fully	complètement
full of zeal	fervent
full payment	réglement
fume	exhalaison
fumy	délétère
fun	amusement
function	fonctionner
fund	fonds
fundamental	radical
funeral	enterrement
funk	peureux
funnel	entonnoir
funny	amusant
fur	fourrure
furious	furieux
furlough	permission
furnace	cuisinière
furnish	fournir
furniture	mobilier
furrow	rider
further	plus loin
furthermore	d'ailleurs
fur coat	fourrure
fur piece	fourrure
fuse	mèche
futile	abortif
future	futur
gadfly	taon
gag	badinage
gain	acquisition
gall	amer
gallant	brave
gallery	galerie
gallop	galoper
galosh	galoche
game	jeu
gang	bande
gaol	prison
gap	brèche
gape	badauder
gape at	regarder bouche bée
garage	garage
garbage can	poubelle
garden	jardin
gardener	jardinier
gardening	jardinage
gargle	rincer
garlic	ail
garlic bulb	tête d'ail
garment	habit
garnish	garnir
garret	mansarde
gas	gaz
gasolene	essence
gasoline	essence
gather	déduire
gathering	réunion
gaunt	angulaire
gawk	badauder
gay	gai
gazette	gazette
gee‐up	hop
gelding	cheval hongre
gendarme	gendarme
gene	gène
general	général
generally	en général
generalship	précaution
generate	engendrer
generation	génération
generous	généreux
genius	génie
gentle	doux
gentleman	monsieur
genuinely	en réalité
genuinly	en fait
geographer	géographe
geographic	géographique
geographical	géographique
geography	géographie
geological	géologique
geologist	géologue
geology	géologie
geometry	géométrie
geranium	géranium
germ	microbe
germinate	germer
gesture	geste
get‐at‐able	abordable
get	acquérir
get dressed	s'habiller
get in	monter
get into a car	monter
get lost	se perdre
get married	se marier
get mouldy	moisir
get off	s'abaisser
get out	descendre
get out of a car	descendre
get rid of	ôter
get tired	se fatiguer
get up	surgir
get used	s'accoutumer
ghastly	désagréable
ghost	apparition
gibbon	gibbon
gift	cadeau
gigantic	formidable
gild	dorer
gill	branchie
giraffe	girafe
gird	boucler
girder	poutre
girdle	ceinture
girl	fille
give	faire cadeau
give an account	rapporter
give an airing	aérer
give as an excuse	prétexter
give a ring	sonner
give birth	accoucher
give birth to	faire naître
give in	abandonner
give notice	annoncer
give off an odour	embaumer
give rise to	causer
give up	abandonner
give utterance to	répandre
give way	abandonner
glad	joyeux
gladiolus	glaïeul
gladness	allégresse
glamor	gloire
glamour	gloire
glass	verre
glasses	lunettes
glaze	vernis
glide	planer
globe	globe
gloomy	morne
glorify	glorifier
glorious	fameux
glory	gloire
glove	gant
glow	brûler
glow with heat	brûler
glue	coller
gnat	cousin
gnaw	ronger
gnome	gnome
gnu	gnou
go	aller
goal	but
goat	chèvre
goblet	coupe
goblin	gnome
god	dieu
godfather	parrain
gold	or
goldfinch	chardonneret
golf	golfe
good‐bye	adieu
good‐hearted	accommodant
good‐natured	affable
good	bon
goodbye‐	d'adieu
goodbye	adieu
good day	bonjour
good evening	bonsoir
good health	à la vôtre
good morning	bonjour
good night	bonne nuit
goose	oie
gooseberry	groseille
gorilla	gorille
gossip	cancaner
gourd	potiron
govern	gouverner
government	gouvernement
gown	robe
go around	circuler
go away	partir
go beyond	passer
go broke	faire banqueroute
go down	s'abaisser
go fast	se dépêcher
go forward	avancer
go for a walk	se promener
go in	entrer
go on	continuer
go on pilgrimage	aller en pélerinage
go out	aboutir
go through	apprendre par l'expérience
go to bed	se coucher
go up	se soulever
grab	agripper
grace	charme
graceful	gracieux
gracefulness	charme
grade	degré
gradually	de proche en proche
grain	grain
gram	gramme
grammar	grammaire
gramme	gramme
grand‐nephew	arrière‐neveu
grand‐niece	arrière‐nièce
grand	grandiose
grandfather	aïeul
grandiose	grandiose
grandmother	aïeule
grandson	petit‐fils
granite	granit
granny	grand‐maman
granule	grain
grape	raisin
grapefruit	pamplemousse
grapevine	vigne
grapple	attraper
grasp	agripper
grass	herbe
grasshopper	criquet
grate	grincer
gratitude	gratitude
grave	tombe
gravel	gravier
graveyard	cimetière
gravity	gravitation
gravy	sauce
grease	graisse
greasy	gras
great‐grandfather	arrière‐grand‐père
great‐grandmother	arrière‐grand‐mère
great	accompli
greatgranddaughter	arrière‐petite‐fille
greatgrandson	arrière‐petit‐fils
greediness	avidité
greedy	avide
green	vert
greenweed	genêt
greet	accueillir
greeting	salut
grey	gris
grid	grille
grief	abattement
grieve	affliger
grill	grille
grind	moudre
grip	agripper
grisly	désagréable
grit	gravier
groan	gémir
groin	aine
grope	tâter
grotto	grotte
ground‐floor	rez‐de‐chaussée
ground	fond
grounds	terrain
group	bande
grow	devenir
growl	grogner
grown‐up	majeur
growth	accroissement
grow sour	s'acidifier
grub	abattre
grudge	rancune
gruel	bouillie
gruesome	abject
gruff	maussade
grumble	grogner
guarantee	assurer
guard	préserver
guess	deviner
guest	convive
guide	diriger
guidebook	guide
guilder	florin
guiltless	innocent
guilty	coupable
guinea‐pig	cobaye
guitar	guitare
gulden	florin
gulf	abîme
gum	gencive
gun	fusil
gunner	artilleur
gunpowder	poudre à canon
gush	jaillir
gusto	vigueur
guy	individu
gymnastics	gymnastique
gypsy	gitan
habit	coutume
hack	hacher
haddock	aiglefin
haemorhoids	hémorrhoïdes
haemorrhoid	hémorrhoïde
haggle	marchander
hail	grêle
hair	cheveu
hairdresser	coiffeuse
hairpiece	perruque
hairs	cheveux
hairy	velu
halcyon	martin‐pêcheur
half	demi
halo	auréole
halt	s'arrêter
ham	jambon
hamlet	hameau
hammer	marteau
hand	ouvrier
handbook	guide
handful	poignée
handicraft	métier
handkerchief	mouchoir
handle	tâter
handlebars	gouvernail
handshake	poignée de main
handsome	beau
handy	commode
hand in	déposer
hang	pendre
hang onto	tenir
happen	devenir
happy	heureux
harbor	port
harbour	port
hard	difficile
harden	durcir
hardly	à peine
hardworking	appliqué
hare	lièvre
haricot	haricot
harm	nuire
harmful	nuisible
harmonious	harmonieux
harness	atteler
harrow	herser
harsh	acerbe
harvest	récolter
haste	hâte
hastily	à la hâte
hat	chapeau
hate	haïr
haul	tirer
have	avoir
have an accident	avoir un accident
have at one's disposal	disposer
have a bath	se baigner
have a good time	se réjouir
have compassion on	avoir pitié
have confidence in	confier
have effect	agir
have faith	se fier
have faith in	se fier
have got	avoir
have sex	baiser
have sexual intercourse	s'accoupler
have to	devoir
hawk	autour
hay	foin
hazard	hasard
hazardous	périlleux
haze	chicaner
hazelnut	noisette
he‐goat	bouc
he	il
head	guider
header	rubrique
heading	intitulé
headlight	phare
head of cattle	tête de bétail
heal	guérir
health	santé
healthy	sain
heap	accumuler
hear	entendre
hearsay	réputation
heart‐	cordial
heart	cœur
hearth	foyer
hearty	cordial
heat	ardeur
heath	bruyère
heating	chauffage
heaven	ciel
heavenly body	astre
heavy	lourd
hectolitre	hectolitre
hectometre	hectomètre
hedge	haie
hedge clippers	taille‐haie
hedge shears	taille‐haie
heel	talon
height	altitude
heighten	aggraver
helium	hélium
helix	hélice
hello	allô
helm	gouvernail
help	aider
helper	adjoint
helpless	abandonné
hemorrhoid	hémorrhoïde
hen	poulet
her	à lui
herald	héraut
herb	herbe
herd	bande
heresy	hérésie
here are	voici
here is	voici
hero	héros
heroic	héroïque
heroin	héroïne
heroine	héroïne
heroism	héroïsme
heron	héron
herring	hareng
herself	même
hesitate	barguigner
hiccup	avoir le hoquet
hide	fourrure
hideous	abject
hide oneself	s'abriter
high	haut
highway	chaussée
high school	collège
high tide	marée haute
hill	colline
hillside	côte
hill up	butter
him	à lui
himself	même
hind	biche
hinder	déranger
hindmost	suivant
hinge	charnière
hinny	bardot
hint	faire allusion
hip	hanche
hippo	hippopotame
hippopotamus	hippopotame
hire	embaucher
his	sa
hiss	siffler
history	histoire
hit	battre
hitch on	aborder
hoarse	rauque
hoax	mystifier
hoe	houe
hog	cochon
hogweed	berce
hold	tenir
hold back	réprimer
hole	fossé
holiday	jour férié
holly	houx
holy	sacré
homage	hommage
home	domicile
honest	honnête
honey	miel
honeysuckle	chèvrefeuille
honor	honorer
honour	honorer
hood	Apache
hoof	sabot
hook	agrafe
hooker	fille
hooks and eyes	agrafe de vêtement
hook on	aborder
hoopoo	huppe
hooter	avertisseur
hop	houblon
hope	espérer
hope for	aspirer
hops	houblon
horizon	horizon
horizontal	horizontal
horn	corne
hornbeam	charme
hornet	taon
horoscope	horoscope
horrible	abject
horror	abomination
horse‐chestnut	châtaigne
horse‐fly	taon
horse‐radish	raifort
horse	cheval
horseradish	raifort
hospital	hôpital
host	aubergiste
hostage	otage
hostel	auberge
hostess	aubergiste
hostile	ennemi
hotel	hôtel
hour	heure
house	maison
housefly	mouche
house of ill fame	bordel
house of worship	église
hover	planer
how	comment
however	cependant
howl	hurler
how are you?	comment allez‐vous?
how do you do?	comment allez‐vous?
how long	pour combien de temps
how many	combien
how much	combien
hub	moyeu
hue	nuance
huge	formidable
hum	bourdonner
humane	charitable
human being	être humain
humble	humble
humble oneself	s'humilier
humility	modestie
hummingbird	oiseau‐mouche
humor	humour
humour	humeur
hump	bosse
humus	humus
hunch‐backed	bossu
hunchback	bossu
hundred	cent
hunger	faim
hunt	chasser
hunter	chasseur
hurricane	ouragan
hurried	hâtif
hurriedly	à la hâte
hurry	se dépêcher
hurt	blesser
husband	époux
husk	coque
hut	cabane
hyaena	hyène
hybrid	hybride
hygiene	hygiène
hygienic	hygiénique
hymn	hymne
hypnosis	hypnose
hypnotic trance	hypnose
hypnotize	hypnotiser
hypocrite	hypocrite
hypocritical	hypocrite
hypothesis	hypothèse
hypothetical	hipothétique
hysteria	hystérie
hysterical	hystérique
ice	crème glacée
icecream	crème glacée
idea	idée
ideal	idéal
identical	identique
identify	identifier
idiot	idiot
idiotic	stupide
if	à condition que
ignore	bouder
ill	malade
illiterate	analphabète
illness	infirmité
illuminate	illuminer
illusion	illusion
illustrate	illustrer
ill fate	fatalité
image	image
imagine	imaginer
imitate	copier
immaterial	indifférent
immediate	immédiat
immediately	aussitôt
immense	énorme
immerse	immerger
imp	lutin
impartial	neutre
impel	inciter
impenetrable	imperméable
imperialism	impérialisme
impertinent	hardi
impetus	transport
implicate	empêtrer
imply	impliquer
import	importer
important	considérable
impose	contraindre
impose upon	imposer
imposing	imposant
impossible	impossible
imposter	charlatan
impress	en imposer à
impressible	sensible
impression	effet
imprint	impression
improve	améliorer
impulse	impulsion
in	à
inaugurate	inaugurer
inauguration	inauguration
inborn	inné
inbred	inné
incendiary bomb	bombe à incendie
inception	début
incest	inceste
incidental	auxiliaire
incite	agiter
incitement	incitation
incline	incliner
inclined	enclin
include	contenir
income	produit
inconceivable	abracadabrant
inconvenient	difficile
increase	accroître
increasingly	de plus en plus
incredible	invraisemblable
incubate	couver
indeed	d'abord
independant	indépendant
index	liste
indicate	désigner
indication	augure
indictment	accusation
indifferent	indifférent
indigenous	autochtone
indigestion	dyspepsie
indispensable	indispensable
indistinct	confu
individual	individu
induce	conclure
inducement	lieu
indulge	être indulgent
industrial	industriel
industrialist	industriel
industrious	appliqué
industry	application
inebriety	ivresse
inert	inerte
infant	enfant
infantry	infanterie
infect	infecter
infected	septique
infer	conclure
infirm	infirme
inflammatory	séditieux
inflate	hausser
inflated	afecté
influence	influer
influenza	grippe
inform	apprendre à
information	faire‐part
inhabitant	habitant
inhale	inspirer
inherit	hériter
inheritance	héritage
initial deposit	acompte
initiate	prendre l'initiative
inject	injecter
injure	abîmer
injury	blessure
ink	encre
inlet	fiord
inn	auberge
innate	inné
inner	intérieur
inner tube	chambreàair
innkeeper	aubergiste
innocent	innocent
inquiry	enquête
inquisitive	curieux
insane	aberrant
insanity	aberration
insect	insecte
insert	introduire
inside	à
insignia	insigne
insignificant	mineur
insist	insister
insistence	impulsion
inspect	inspecter
inspector	inspecteur
inspiration	souffle
inspire	dicter
install	construire
installment payment	acompte
instalment	acompte
instant	instant
instantly	aussitôt
instead of	au lieu de
instigate	inciter
instinct	instinct
institute	institut
institution	fondation
instruction	instruction
instructor	instituteur
insubordinate	désobéissant
insulate	isoler
insult	insulter
insurance	assurance
insure	assurer
insurer	assureur
integer	entier
intellectual	intellectuel
intelligence	intelligence
intelligent	intelligent
intend	avoir pour but
intense	intense
intensive	intense
intention	dessein
intercessor	avocat
interchange	échanger
interest	intéresser
interesting	intéressant
interface	interface
interfere with	brouiller
interjection	interjection
interment	enterrement
intermission	pause
internal	intérieur
international	international
interpret	interpréter
interpreter	interprète
interpunction	ponctuation
interrogate	interroger
interrupt	interrompre
interruption	interruption
interval	intervalle
intervene	intervenir
interview	entrevue
intestine	intestin
intimate	intime
into	à
intone	entonner
intoxicated	ivre
intrepid	audacieux
intrigue	intriguer
introduce	offrir
introduction	introduction
invade	envahir
invasion	invasion
invent	inventer
invention	invention
inventory	recensement
inverted comma	guillemet
invest	investir
investigate	examiner
investigation	examen
invitation	invitation
invite	inviter
invite tenders for	mettre à l'entreprise
invoice	facture
invoke	invoquer
in accordance with	conforme à
in action	actif
in addition	d'ailleurs
in a hurry	à la hâte
in a way	comme
in detail	abondamment
in easy circumstances	aisé
in every way	de toute manière
in exchange for	contre
in fact	en réalité
in front of	avant
in good condition	intact
in no way	en aucune façon
in order to	à
in question	concerné
in short supply	insuffisant
in spite of	malgré
in the beginning	d'abord
in the evening	le soir
in the final analysis	proprement
in the meantime	dans l'intervalle
in the middle of	au milieu de
in the morning	le matin
in the presence of	devant
in time	à temps
in turn	successivement
in vain	en vain
in what way	comment
iodine	iode
iris	iris
iron	fer
irony	ironie
iron clothes	repasser]
irrigate	abreuver
island	île
isn't it	hein
isn't that so	hein
isolate	isoler
isolation	abandon
issue	éditer
it	à lui
itch	démanger
its	leur
itself	même
it doesn't matter	cela ne fait rien
ivory	ivoire
ivy	lierre
jack	bambin
jackal	chacal
jacket	veste
jail	prison
jam	confiture
jaw	mâchoire
jawbone	mâchoire
jaws	gouffre
jealous	jaloux
jealousy	envie
jeer at	bafouer
jelly‐fish	méduse
jenny‐ass	ânesse
jest	badiner
jester	arlequin
jet plane	avion à réaction
jewel	bijou
jeweller	bijoutier
jingle	tinter
job‐	à forfait
job	ouvrage
jog	faire du jogging
join	adhérer
joining	accouplement
joint	articulation
joke	badiner
journal	journal
journalist	journaliste
journey	voyage
joy	allégresse
joystick	gouvernail
judge	juger
judgement	arrêt
jug	cruche
juggle	jongler
juice	jus
jumbled up	confus
jump	sauter
junction	accouplement
june bug	hanneton
jungle	jungle
jurisprudence	droit
just	juste
just now	à l'instant
keen	actif
keep	continuer
keeper of the records	archiviste
keepsake	souvenir
keep an eye on	épier
keep on	continuer
kernel	centre
kettle	chaudron
key	touche
keyboard	clavier
kidney	rein
kill	abattre
kill oneself	se suicider
kiln	cuisinière
kilo	kilogramme
kilobyte	kilobyte
kilometre	kilomètre
kimono	kimono
kind	affable
kindle	allumer
kindness	amabilité
king	dame
kingdom	royaume
kingfisher	martin‐pêcheur
kingship	règne
kiss	baiser
kitchen	cuisine
kite	milan
klaxon	avertisseur
knapsack	sac tyrolien
knead	pétrir
knee	genou
kneel	s'agenouiller
knife	couteau
knight	chevalier
knit	tricoter
knock	frapper
knock off	débattre
knot	nouer
know	connaître
knowledge	connaissance
know how	savoir
krypton	krypton
laboratory	laboratoire
laborer	ouvrier
labor exchange	bourse du travail
labour‐union	syndicat
labour	accoucher
labourer	ouvrier
labour exchange	bourse du travail
lace	dentelle
lack	défaut
lad	garçon
ladder	échelle
laddie	garçon
lady	demoiselle noble
ladybug	coccinelle
lagoon	lagune
lake	lac
lamb	agneau
lame	boiteux
lament	se lamenter
lamp‐shade	abat‐jour
lamp	lampe
land	aborder
landing‐stage	débarcadère
landlady	aubergiste
landlord	aubergiste
landscape	paysage
lane	ruelle
language	langue
lantern	lanterne
lap	barboter
lapse	retomber
lapsed	caduc
larch	mélèze
larder	buffet
large	grand
lark	alouette
larva	larve
lass	fille
last	précédent
lasting	permanent
last night	hier soir
lately	dernièrement
laud	glorifier
laugh	rire
launch	lancer
laurel	laurier
lavender	lavande
law	droit
lawn	batiste
lawsuit	procès
lawyer	avocat
lay	coucher
layer	couche
layman	laïc
lay down	appliquer
lay hold of	prendre
lay out	étendre
lead	guider
leader	conseiller
leaf	feuille
leaflet	brochure
leaf through	feuilleter
league	lieue
lean	accoter
leap	sauter
learn	apprendre
learned	cultivé
learnt	appris
lease	affermer
leasurely	lentement
leather	cuir
leave	partir
leave out	omettre
leave out of account	bouder
leaving certificate	baccalauréat
leaving examination	baccalauréat
lectern	pupitre
lecture	conférence
leech	sangsue
leek	ail
left	gauche
leg	jambe
legal	légitime
leisurely	paisiblement
lemon	citron
lend	emprunter
length	longueur
lengthen	allonger
lenient	indulgent
lentil	lentille
leopard	léopard
lessen	abaisser
lesson	leçon
less and less	de moins en moins
let	laisser
letter	lettre
letterbox	boîte aux lettres
letter of introduction	lettre de recommandation
letter of recommendation	lettre de recommandation
lettuce	laitue
let know	apprendre à
level	plat
lever	lever
library	bibliothèque
licence	licence
license	licence
lick	lécher
lid	couverture
lie	être couché
lieutenant	lieutenant
lie down	se coucher
life	vie
lift	lever
light	allumer
lighthouse	phare
lightning	éclair
like	comme
likely	vraisemblable
likewise	aussi
like that	ainsi
lilac	lilas
lily‐of‐the‐valley	muguet
lily	lis
limb	membre
lime‐tree	tilleul
lime	chaux
limit	limiter
linden‐tree	tilleul
line	ligne
linen	toile
link	monter
link together	enchaîner
link up	enchaîner
lion	lion
lip	lèvre
liquid	flot
liquidate	liquider
liquid manure	purin
lira	lire
list	liste
listen	écouter
listener	auditeur
liter	litre
literature	littérature
lithium	lithium
litre	litre
little	petit
little bell	clochette
little bird	oisillon
little boat	barquette
little by little	de proche en proche
little stick	bâtonnet
live	demeurer
lively	fin
liver	foie
live to see	apprendre par l'expérience
lizard	lézard
load	charger
loaf	pain
loan	emprunter
loathe	abhorrer
lobster	homard
local	local
locate	placer
location	déstination
loch	fiord
lock	écluse
lock up	serrer
locust	criquet
lofty	haut
logic	logique
logical	logique
logical reasoning	raison
loin	lombes
long	long
long for	aspirer
look	avoir l'air de
looking‐glass	miroir
look after	garder
look askance	loucher
look at	contempler
look for	chercher
loop	maille
lord	monsieur
lorry	camion
lose	perdre
loss	perte
lottery	loterie
loud	haut
loudly	à haute voix
lounge	salon
louse	pou
love	aimer
lovely	agréable
lover	amante
loving	amoureux
low	abject
lower‐arm	avant‐bras
lower	abaisser
lowering	abaissement
lower case letter	minuscule
lower part of the body	abdomen
low relief	bas‐relief
low tide	marée basse
loyal	droit
luck	destinée
luggage	bagage
lukewarm	tiède
lull	bercer
lump	boule
lunacy	aberration
lunatic	aliéné
lung	poumon
lupine	lupine
lure	attirer
lust	passion
lute	luth
luxury	richesse
lyceum	lycée
lye	lessive
lying‐in room	chambre de travail
lying‐in woman	accouchée
lynx	lynx
lyre	lyre
lyric	texte
machine	machine
machine of government	appareil administratif
mackerel	maquereau
mad	aberrant
madam	madame
madness	aberration
maestro	maestro
magazine	gazette
magic	magie
magical	magique
magician	sorcier
magnesium	magnésium
magnificent	grandiose
magnifying glass	loupe
magpie	pie
maid	domestique
mail	courrier
mailbox	boîte aux lettres
main	principal
mainland	continent
mainly	principalement
maintain	conserver
maintenance	garde
maize	maïs
majestic	imposant
majesty	majesté
major	commandant
majority	majorité
make‐up	fard
make	construire
make an offer of	offrir
make a contract	contracter
make a deposit	payer un premier acompte
make a down payment	payer un premier acompte
make a mistake	se tromper
make a noise	faire du bruit
make a note	noter
make a project of	projeter
make a stroke	abaisser
make clean	affinier
make fast	attacher
make for	s'adresser à
make fun of	bafouer
make glad	réjouir
make love	faire l'amour
make up	maquiller
make use of	appliquer
make war	guerroyer
making	activité
malaria	malaria
male	mâle
male cook	cuisinier
malicious	méchant
mallet	maillet
mam	maman
mammal	mammifère
mammy	maman
man	être humain
manage	administrer
manageability	docilité
manageable	conciliant
management	administration
manager	administrateur
mandate	mandat
maneuver	intrigue
manger	auge
manifacture	activité
manifest	manifester
manipulate	manier
manna	manne
manner	manière
manoeuvre	intriger
mansion	immeuble
mantle	manteau
manufacture	fabriquer
manure	engrais
many	nombreux
manœuvre	intrigue
map	carte
maple	érable
marble	marbre
march	marcher
march off	décéder
margin	marge
marguerite	marguerite
marigold	calendula
maritime	marin
mark	marquer
market	bazar
marketplace	marché
marmelade	confiture
marriage	mariage
married	mariée
married people	couple
marry	se marier
marsh	marais
marten	marte
martyr	martyre
marvel	s'étonner
marvel at	s'étonner
masculine	mâle
mask	masque
mason	maçon
mass	amas
massacre	massacrer
massage	masser
massive	massif
mast	mât
master	apprendre à fond
masturbate	se masturber
match‐make	s'entremettre
match	allumette
mate	s'accoupler
material	matériel
mathematical	mathématique
mathematics	mathématiques
matrimony	mariage
matter	affaire
mattress	matelas
mature	fait
maw	gouffre
maxim	sentence
maximum	maximum
maybe	peut‐être
mayhap	peut‐être
mayor	maire
me	à moi
meadow	prairie
meager	maigre
meal	farine
mealies	maïs
mean	intermédiaire
meaning	dessein
means	instrument
meanwhile	dans l'intervalle
measurable	prévisible
measure	mesurer
measurement	dimension
meat	viande
mechanic	mécanicien
mechanics	mécanique
medal	médaille
mediation	intermédaire
medicine	remède
meditate	méditer
meet	réunir
meeting	séance
meet with	contenter
melancholy	mélancolique
melody	mélodie
melon	melon
melt	dégeler
member	adhérent
memento	souvenir
memorize	apprendre par cœur
memory	mémoire
menace	gronder
menacing	sinistre
mend	rapiécer
mend one's pace	presser le pas
mental	intellectuel
mention	mentionner
menu	carte
merchandise	marchandise
merchant	commerçant
merciful	sensible
mercifulness	compassion
mercury	mercure
mercy	compassion
mere	pur
merit	mériter
merry	gai
mesh	maille
mess	bouillie
message	message
metal	métal
metamorphosis	transformation
meteoric stone	aérolithe
meteorite	aérolithe
method	méthode
methylated spirit	alcool dénaturé
metre	mètre
mica	mica
microbe	microbe
micrometre	micromètre
midday	midi
midday meal	déjeuner
middle	intermédiaire
middleclass citizen	bourgeois
midget	nain
midwife	accoucheuse
migrate	voyager au loin
mild	doux
milk	lait
mill	usine
miller	meunier
millimetre	millimètre
milliner	modiste
mind	esprit
mine	mine
miner	mineur
mineral	minéral
mingle	mélanger
minimum	minimum
minister	ministre
ministry	ministère
minority	minorité
mint	menthe
minus	moins
minute	minute
minutes	compte‐rendu
miracle	miracle
mirror	miroir
miscarriage	avortement
miscarry	avorter
mischievous	méchant
miserable	lamentable
miserliness	avarice
miserly	avare
misery	misère
miss	manquer
mission	mission
missionary	missionnaire
mist	brouillard
mistake	erreur
mistaken	abusif
mistletoe	gui
mistress	maîtresse
misunderstanding	malentendu
mite	acarien
mitten	gant
mix	mélanger
moan	gémir
mobile	mobile
mock	bafouer
mockery	simulacre
mode	manière
model	modèle
moderate	abordable
modern	moderne
modest	modeste
modesty	modestie
modify	modifier
moist	humide
mold	modeler
mole	taupe
mom	maman
moment	instant
mommy	maman
monastery	couvent
money‐box	caisse
money	argent
money box	caisse
money order	mandat‐poste
mongrel	hybride
monk	moine
monkey	singe
monkshood	aconit
monopolize	accaparer
monotonous	monotone
monsignor	monseigneur
monster	clébard
month	mois
monthly	mensuel
monument	monument
mood	ambiance
moon	lune
moor	attacher
moose	élan
moped	vélomoteur
moral	moral
morality	vertu
morals	morale
more	davantage
moreover	d'ailleurs
mores	coutume
more and more	de plus en plus
morning	matin
morphia	morphine
morphine	morphine
morter	mortier
mortgage	hypothèque
mosque	mosquée
mosquito	moustique
moss	mousse
most	extrêmement
mostly	plupart
most important	dominant
moth	mite
mother	mère
motion	motion
motionless	au repos
motion picture	film
motive	lieu
motor‐boat	vedette
motor‐launch	vedette
motor	moteur
motorcycle	moto
motoring	automobilisme
motorist	automobiliste
motorway	autoroute
motor road	autoroute
motto	devise
mould	modeler
mouldy	moisi
mount	adapter
mountain	mont
mountaineer	alpiniste
mountaineering	alpinisme
mountain chain	massif
mountain climber	alpiniste
mountain lion	puma
mountain pass	col
mountain ridge	arête
mounting	montage
mourn	regretter
mournful	morne
mourning	deuil
mouse	souris
moustache	moustache
mouth	bouche
move	affecter
movement	mouvement
movie	film
moving	attendrissant
mow	faucher
much	beaucoup
muck‐water	purin
mud	boue
mulberry‐tree	mûrier
mule	mulet
multicoloured	bigarré
multiple	multiple
multitude	amas
munition	munitions
murder	assassiner
murderer	meurtrier
murk	obscurité
murmur	murmurer
muscle	muscle
museum	musée
mush	bouillie
mushroom	champignon
music	musique
musical time	mesure
musician	musicien
musk‐rat	ondatra
musket	mousquet
musquash	ondatra
mussel	moule
must	devoir
mustard	moutarde
musty	moisi
mute	muet
mutiny	révolte
mutter	murmurer
mutton	mouton
mutual	réciproque
mutually	se
muzzle	muselière
my	ma
myrrh	myrrhe
mysterious	mystérieux
mystery	mystère
mystic	mystique
mystical	mystique
mysticism	mysticisme
mystification	mystification
mystify	mystifier
myth	mythe
mythical	mythique
mythologist	mythologue
mythology	mythologie
myxomatosis	myxomatose
nail	clouer
naked	nu
name	nom
nameless	anonyme
nape	nuque
napkin	serviette
narcissus	narcisse
narrate	conter
narrative	récit
narrow	étroit
nasturtium	capucine
nasty	antipathique
nation	nation
national	national
native	autochtone
natural	naturel
naturally	bien sûr
nature	caractère
naught	zéro
naughty boy	affreux jojo
nauseate	écœurer
nave	moyeu
navel	nombril
navigate	naviguer
naïf	naïf
naïve	naïf
near‐sighted	myope
near	à
nearby	à
nearly	presque
near to	à
neat	net
necessary	nécessaire
necessity	nécessité
neck	col
necktie	cravate
need	avoir besoin de
needle	aiguille
needlework	couture
needy	vide
neglect	dédaigner
neglectful	négligent
negligence	négligence
negligent	négligent
neighbour	voisin
neighbourhood	quartier
neighbouring	adjacent
neither	nul
neither ... nor	ni ... ni
nematode	nématode
neon	néon
nephew	neveu
nerve	nerf
nervous	nerveux
nest	faire son nid
net	net
nettle	ortie
network	filet
neutral	neutre
never	jamais
nevertheless	cependant
never mind	cela ne fait rien
new	nouveau
newness	primeur
news	actualités
newspaper	gazette
next	après
next to	à
nibble	ronger
nice	agréable
niche	niche
nickel	nickel
niece	nièce
nigger	bougnoul
night	nuit
nightingale	rossignol
nine	neuf
nineteen	dix‐neuf
ninety	quatre‐vingt‐dix
nip	apéritif
nipple	mamelon
nitrogen	azote
no‐one	nul
no‐one's	à personne
no	non
noble	élevé
nobleman	noble
nobleness	grandeur
nobody	nul
node	nœud
noiseless	silencieux
nomination	liste
non‐military	civil
none	nul
nonsense	absurdité
noon	midi
normal	standard
north	nord
nose	nez
nostalgia	nostalgie
not	ne ... pas
notary	notaire
notch	encoche
note	billet
notebook	cahier
noteworthy	remarquable
nothing	le néant
notice‐board	panneau d'affichage
notice	affiche
notion	notion
notwithstanding	malgré
not an ace	rien
not at all	en aucune façon
not easily	difficilement
not on any account	en aucune façon
nought	zéro
nourish	alimenter
nourishment	aliment
novel	nouveau
now	eh bien
nowadays	actuellement
nowhere	nulle part
now and then	de temps en temps
no doubt	sans doute
no longer	ne ... plus
nuance	nuance
nuclear	nucléaire
nucleus	centre
nude	nu
null	zéro
number	nombre
numeral	chiffre
nurse	soigner
nut	écrou
nuts	aberrant
nutty	aromatique
nylon	nylon
nymph	nymphe
oak	chêne
oar	aviron
oasis	oasis
oath	serment
oats	avoine
obedient	docile
obey	obéir
object	chose
obliging	complaisant
oblique	oblique
obscure	obscur
observation	observation
observe	agir selon
obsess	obséder
obstacle	obstacle
obstetrician	accoucheuse
obstinate	obstiné
obstruct	barrer
obtain	acquérir
obtainable	accessible
obtuse	obtus
obvious	évident
obviously	évidemment
occasion	fois
occupation	métier
occupy	occuper
occur	arriver
occurrence	occasion
ocean	océan
octopus	poulpe
odd	bizarre
odor	odeur
odour	odeur
of	de
offal	abats
offence	agacement
offend	insulter
offer	offrir
office	bureau
officer	officier
official	oficiel
offset	distance
offspring	descendance
often	beaucoup
of ... to	... à
of a star	astral
of course	bien entendu
of paramount importance	souverain
of silk	soyeux
of steal	d'acier
of the	de la
of the sea	marin
of the sun	ensoleillé
of use	apte à
of water	aquatique
of which	dont
oh	ah
ohm	ohm
oil	huile
okay	bon
old	vieux
old man	vieillard
olive‐tree	olivier
olive	olive
omen	augure
omit	omettre
omnibus	autobus
on	en avant
once more	de nouveau
one	un
onerous	lourd
one hundred	cent
one more	supplémentaire
one thousand	mille
onion	oignon
only	ne ... que
only just	à peine
on account of	à cause de
on end	de suite
on purpose	exprès
on that account	aussi
on the occasion of	à propos de
on the other side of	au‐delà de
on the recommendation of	sur la recommandation de
on the right	à droite
on time	ponctuel
on top	dessus
open	ouvrir
opening	orifice
open up	ouvrir
operate	fonctionner
operation	opération
operative	ouvrier
opine	être d'avis
opinion	avis
opponent	adversaire
opportune	commode
opportunity	occasion
oppose	rouspéter
opposed to	contre
opposite	vis‐à‐vis
opposition	opposition
oppress	appuyer en écrasant
oppressive	étouffant
optician	opticien
optimism	optimisme
option	alternative
or	ou
orange‐coloured	orange
orange‐tree	oranger
orange	orange
orator	orateur
orbit	orbite
orchard	verger
orchestra	orchestre
orchestrate	adapter
orchestration	adaptation musicale
ordain	destiner
ordeal	désolation
order	commander
ordinarily	ordinairement
ordinary	ordinaire
ore	minerai
organ	organe
organize	organiser
orgy	orgie
origin	origine
original	inédit
originate	provenir
ornament	ornament
orphan	orphelin
orthodox	orthodoxe
orthography	orthographe
or not	hein
oscillate	osciller
ostrich	autruche
other	autre
ouch	aïe
ought to	devoir
out	dehors
outfit	complet
outing	excursion
outline	silhouette
outset	début
outside	en dehors de
outside of	en dehors de
out of	de
oven	cuisinière
over	au‐dessus de
overall	total
overalls	blouse longue
overcoat	paletot
overflow	déborder
overground	aérien
overhaul	dépasser
overhead	aérien
overlay	recouvrir
overlook	omettre
overshoe	galoche
overtake	passer
overthrow	abattre
overtone	harmonique
overture	ouverture
overwhelm	abreuver
over there	là
ow	aïe
owe	avoir une dette
owing to	à cause de
owl	chouette
own	posséder
ownership	propriété
ox	bœuf
oxygen	oxygène
oyster	huître
ozone	ozone
o'clock	heure
pace	faire les cent pas
pacifier	sucette
pack	paquet
packet	paquet
pad	bloc
paddle	barboter
padre	aumônier
page	page
pail	seau
pain	douleur
painful	pénible
paint	couleur
paintbrush	pinceau
painter	peintre
pair	apparier
pair of pincers	tenailles
pal	camarade
palace	palais
pale	pâle
palladium	palladium
palm	paume
palmtree	palmier
pamper	choyer
pamphlet	brochure
pancake	crêpe
panel	lambris
panic	panique
pansy	pensée
panther	panthère
panties	caleçon
pantry	buffet
pants	pantalon
paparazzo	paparazzo
paper	document
paperback	brochure
paprika	paprika
parachute	parachute
parade	parader
paradise	paradis
paradox	paradoxe
paraffin‐oil	pétrole
paragraph	alinéa
parallel	parallèle
paralyse	paralyser
parapet	balustrade
parasite	parasite
parcel	paquet
pardon	excuser
parenthesis	parenthèse
parents‐in‐law	beaux‐parents
parents	parents
parish	paroisse
park	garer
parliament	parlement
parlour	salon
parrot	perroquet
parsley	persil
part	part
parterre	parterre
partially	en partie
participate	participer
participle	participe
particular	particulier
particularly	particulièrement
partly	en partie
partridge	perdrix
party	adhérents
party members	adhérents
pass	permission
passage	corridor
passenger	passager
passion	ardeur
passport	passeport
pass away	décéder
pass by	passer
pass the night	passer la nuit
pass through	abattre
past	passé
paste	agglutiner
paste up	agglutiner
pastor	curé
pat	taper
patch	rapiécer
patch up	rapiécer
pate	tête
path	chemin
patience	patience
patient	patient
patriot	patriote
patrol	reconnaissance
patrolman	gendarme
patron	protecteur
pattern	schéma
pause	pause
pavement	pavé
pavilion	pavillon
paw	jambe
pawn	emprunter sur gages
pay	payer
paying off	congé
payment	réglement
pay attention	surveiller
pay attention to	surveiller
pay off	acquitter
pay out	dépenser
pea	pois
peace	paix
peach	pêche
peacock	paon
peak	bout
peal	sonner
peanut	arachide
pear‐tree	poirier
pear	poire
pearl	perle
peasant	paysan
peat	tourbe
peculiar	drôle
pedal	pédale
pedestrian	piéton
peel	dépouiller
peep	gazouiller
peevish	maussade
peg	apéritif
pelican	pélican
pelvis	bassin
pencil	crayon
penetrate	entrer
peninsula	péninsule
penis	pénis
pension	pension
penthouse	abri
people	gens
pepper	poivre
per	à
perceive	s'apercevoir
percent	pourcentage
percentage	pourcentage
perchance	peut‐être
perfect	accompli
perfection	perfection
perform	paraître
perfume	parfumer
perhaps	peut‐être
peril	danger
period	période
periodical	gazette
perish	périr
periwinkle	pervenche
permanent	continuel
permission	autorisation
permit	permettre
perplexity	embarras
persecute	poursuivre
persevere	persévérer
persist	persévérer
person	personnage
personal	personnel
personality	caractère
perspective	perspective
perspiration	sueur
persuade	convaincre
perturb	brouiller
pessimism	pessimisme
pessimist	pessimiste
pestle	pistil
pet	choyer
petal	pétale
petrol	essence
petroleum	pétrole
pettish	maussade
petulant	maussade
phantom	apparition
pharmaceutical	remède
phase	phase
pheasant	faisan
pheasant's eye	adonis
phenomenon	phénomène
phi	horreur
philosophy	philosophie
phoenix	phénix
phone booth	cabine téléphonique
phonograph	phonographe
phosphorus	phosphore
photograph	photographier
photographer	photographe
photography	photographie
physician	docteur
physics	physique
piano	piano
pick‐axe	pioche
pick	cueillir
pickle	affreux jojo
pick out	adopter
pick up	accélérer
picture	image
picturesque	pittoresque
pie	pâté
piece	contingent
piece of furniture	meuble
piece of mail	correspondance
pier	débarcadère
pig	cochon
pigeon	colombe
pigeonhole	domaine
piglet	cochonnet
pigmy	pygmée
pike	brochet
pile	amas
pile up	accumuler
pill	pilule
pillar	colonne
pillow	oreiller
pilot	pilote
pimple	bouton
pin	épingle
pincers	pinces
pinch	pincer
pine‐tree	pin
pine	pin
pineapple	ananas
pink	œillet
pioneer	pionnier
pious	pieux
pip	grain
pipe	pipe
pistol	pistolet
piston	piston
pit	fossé
pitcher	cruche
pitiful	malheureux
pity	mal
pivot	pivot
placard	afficher
place	adapter
place of refuge	abri
place of worship	église
plain	plaine
plait	natter
plan	dessein
plane‐tree	platane
plane	aéroplane
planet	planète
plank	panneau
plant	planter
plash	barboter
plaster	revêtir
plastic	plastique
plate	met
plateau	plateau
platform	tenue
platinum	platine
platter	met
plausible	vraisamblable
play	jouer
plaza	esplanade
plea	argument
plead	plaider
pleasant	agréable
pleasantly	agréablement
pleasantness	agrément
please	s'il vous plaît
pleased	content
pleasure	plaisir
plentiful	abondant
plenty	abondance
plenty of	beaucoup de
plot	intrigue
plough	labourer
pluck	cueillir
plug	bougie
plug in	aboucher
plug up	boucher
plum	prune
plunder	piller
plunge	plonger
plus	plus
plutonium	plutonium
pocket	poche
podium	estrade
poem	poème
poet	poète
poetry	poésie
point	bout
pointed	pointu
point out	indiquer
poison	poison
poisonous	venimeux
pole	pieu
police‐station	commissariat
police	police
policeman	agent
policy	politique
polish	polir
polite	courtois
politeness	politesse
politics	politique
polyp	pieuvre
polyvinyl chloride	chlorure de polyvinyle
pomp	pompe
pond	étang
pool	s'accoupler
poor	malheureux
pope	pape
poplar	peuplier
poppy	coquelicot
popular	populaire
population	population
pork	porc
porpoise	marsouin
port	port
portent	augure
porter	bagagiste
porthole	lucarne
portrait	portrait
port side	bâbord
pose	agir avec affectation
poseur	faiseur d'embarras
position	position
positive	positif
possess	posséder
possession	possession
possible	possible
possibly	peut‐être
post‐paid	affranchi
post	afficher
postage	port
postage stamp	timbre
postal rates	tarif postal
postcard	carte postale
poster	affiche
postman	facteur
postpone	ajourner
postulate	demander
post office	bureau de poste
post up	afficher
pot	pot
potassium	potassium
potato	pomme de terre
pound	broyer
pour	verser
pour out	verser
powder	poudre
power	puissance
powerful	puissant
power station	central
practical	réel
practice	appliquer
practise	exercer
praise	glorifier
prawn	crevette
pray	prier
prayer	prière
preach	prêcher
precede	avancer
precious	rare
precipice	abîme
precise	net
precision	exactitude
predisposition	aptitude
predominant	principal
predominating	souverain
preface	introduction
prefer	aimer mieux
preferably	mieux
prefix	préfixe
pregnant	enceinte
prejudice	parti‐pris
premium	prix
preparation	préparation
prepare	préparer
prepay	affranchir
preposition	préposition
presage	augure
prescription	recette
presence	présence
present‐day	actuel
present	actuel
presentation	offre
present with	offrir
preservation	garde
preservative	préservatif
preserve	préserver
preside	présider
president	président
press	presse
pressure	impulsion
press firmly	presser
prestige	gloire
presume	aspirer à
pretend	prétexter
pretext	prétexte
pretty	aimable
prevent	empêcher
previous	précédent
previously	auparavant
prey	proie
price	prix
pricey	précieux
prick	bitte
priest	abbé
primeval forest	forêt vierge
primrose	primevère
prince	prince
princess	princesse
principal	principal
principally	principalement
principle	principe
print	impression
printed matter	impression
printer	imprimeur
prior	précédent
prison	prison
prisoner	prisonnier
private	privé
privet	troène
privilege	privilège
privileged	privilégié
prize	prix
probable	vraisemblable
probably	probablement
problem	problème
proboscis	trompe
procedure	procédé
proceed	procéder
proceed with	continuer
process	procédé
procession	procession
proclaim	proclamer
proclamation	déclaration
procure	procurer
produce	produire
production	production
profane	violer
profess	avouer
profession	profession
professor	professeur
profit	bénéfice
profound	profond
profuse	abondant
prognosis	prognostic
programme	programme
progress	avancer
prohibit	interdire
project	projeter une image
proletarian	prolétaire
prologue	prologue
promenade	promenade
promise	assurer
promote	promouvoir
promotion	année
promotor	promoteur
prompt	ponctuel
pronounce	prononcer
pronunciation	prononciation
proof	preuve
prop	appui
propaganda	propagande
propeller	hélice
proper	convenable
properly	convenablement
property	bien
prophesy	prédire
prophet	prophète
proportion	proportion
prosecute	poursuivre
prospectus	prospectus
prosper	prospérer
prosperity	prospérité
prostitute	prostituer
prostitution	prostitution
protect	préserver
protection	garde
protectionist	protecteur
protect from	s'abriter
protein	protéine
protest	protester
protocol	compte‐rendu
proton	proton
prototype	prototype
proud	altier
prove	démontrer
proverb	proverbe
provide	munir
provided that	à condition que
province	province
provisional	provisoire
provoke	agacer
provost	maire
proximity	voisinage
prude	bégueule
prudence	précaution
prudent	prudent
prudish	bégueule
psalm	psaume
pseudonym	pseudonyme
psyche	psychisme
psychiatrist	aliéniste
psychiatry	psychiatrie
psychic	psychique
psychologist	psychologue
psychology	psychologie
pub	abreuvoir
puberty	adolescence
public	public
publicity	propagande
publicize	propager
public prosecutor	procureur
public square	esplanade
publish	éditer
pull	tirer
pullover sweater	chandail
pull down	abattre
pull out	répandre
pull to pieces	abaisser
pulse	pouls
pulverize	moudre
puma	puma
pump	pomper
pumpkin	potiron
punctual	ponctuel
punctuate	parsemer
punctuation	ponctuation
punish	punir
punishment	peine
puppet	guignol
purchase	achat
purchaser	acheteur
pure	blanc
purge	affinier
purity	propreté
purple	pourpre
purpose	but
purse	porte‐monnaie
pursue	poursuivre
pursue one's point	persévérer
pus	pus
push	pousser
push along	faire glisser
pussy	chatte
put	appliquer
putrefy	pourrir
put away	serrer
put down	appliquer
put in	introduire
put in order	ordonner
put off	enlever
put on	activer
put onto	appliquer
put on airs	agir avec affectation
put on stamps	affranchir
put on the stage	offrir
put out	éteindre
put out to tender	mettre à l'entreprise
put right	joindre
put together	assembler
put to bed	coucher
put to sleep	assoupir
put up	adapter
put up with	endurer
puzzle	énigme
pyjamas	pyjama
pyramid	pyramide
quack	charlatan
quail	caille
quaint	curieux
qualify	qualifier
quality	propriété
quantity	quantité
quarrel	dispute
quarter	quartier
quash	abîmer
quay	quai
queen	dame
quell	étouffer
quest	recherche
question	question
quibble	chicaner
quick	prompt
quickly	rapidement
quicksilver	mercure
quiet	calme
quietly	paisiblement
quietness	repos
quilt	coudre
quince	coing
quinsy	angine
quit	démissioner
quite	assez
quiver	trembler
quivering	frisson
quotation	citation
quotation mark	guillemet
quotation marks	guillemets
quote	citer
quotes	guillemets
rabbi	rabbin
rabbit	lapin
rabies	rage
raccoon	raton laveur
race‐course	piste
race	s'élancer
rack	arack
racoon	raton laveur
radiate	rayonner
radiator	radiateur
radical	radical
radio	radio
radish	radis
radium	radium
radius	rayon
radon	radon
raffle	loterie
raft	radeau
rag	chiffon
ragout	ragoût
rail	rail
railing	balustrade
railroad	chemin de fer
railway	chemin de fer
railway carriage	wagon
rain	pleuvoir
rainbow	arc‐en‐ciel
raincoat	imperméable
raise	élever
raise the alarm	alarmer
rake	râteler
ram	bélier
ranch	bien
rancour	rancune
rand	rand
random	accidentel
rank	grade
rap	rapper
rapid	prompt
rapsody	rapsodie
rare	rare
rasp	râper
raspberry	framboise
rat	rat
rate	proportion
rather	une certaine quantité
rational	rationnel
rattle	claquer
rave	être fou
raven	corbeau
ravine	abîme
raw	brut
ray	rayon
razor	lame
re‐read	relire
reach	aboutir
reaction	réaction
read	lire
reader	lecteur
ready	prêt
read again	relire
read over again	relire
real	effectif
reality	réalité
realize	comprendre
really	en réalité
realm	puissance
rear	arrière‐garde
rearguard	arrière‐garde
reason	cause
reasonable	abordable
rebate	rabais
rebel	se révolter
rebellion	révolte
rebellious	rebelle
rebound	rebondir
rebuke	repousser
recall	retenir
receipt	quittance
receive	accepter
recent	frais
recently	récemment
reception‐room	réception
receptionist	receptionniste
reception room	réception
recess	alcôve
recipe	recette
recipient	destinataire
reciprocal	réciproque
reciprocally	se
recite	réciter
reclaim	acquérir péniblement
recline	être couché
recognize	croire
recollect	retenir
recollection	mémoire
recommend	recommander
recommendable	recommandable
recommendation	liste
recommend oneself	se recommander
record‐player	phonographe
record	disque
recover	recouvrer
recovery	salut
recreation	transformation
recruit	recruter
red	rouge
reduce	abaisser
reduce the price	répondre
red currant	groseille
red of dawn	aurore
reed	roseau
reef	écueil
reek	embaumer
refashioning	transformation
referee	arbitre
refine	raffiner
refined	délicat
reflect	réfléchir
reflection	reflet
reflect on	réfléchir
reform	reformer
refresh	rafraîchir
refrigerator	réfrigérateur
refuge	refuge
refugee	réfugié
refuse	refuser
refute	rejeter
regain	rattraper
regal	royal
regard	estime
regeneration	transformation
regiment	régiment
region	contrée
regional	local
register	enregistrer
registered	recommandé
registered letter	lettre recommandée
registered share	action nominative
regret	regretter
regrettably	malheureusement
regular	régulier
regularly	beaucoup
regulate	régler
regulation	règle
regulations	réglement
reign	commandement
reign of terror	terreur
reject	rejeter
rejoice	être joyeux
relate	conter
related by marriage	par alliance
relation	abord
relations	proches
relative	parente
relatively	relativement
relatives	proches
relax	se relâcher
release	dégager
relevance	à‐propos
reliable	sûr
religion	religion
religious	religieux
relinquish	abandonner
relinquishment	abandon
relish	se délecter
remain	rester en arrière
remainder	débris
remaining	autre
remark	remarque
remarkable	remarquable
remedy	guérir
remember	retenir
remiss	négligent
remissness	négligence
remit	abroger
remote	loin
removal	déménagement
remove	ôter
rendezvous	rencontre
renew	reconduire
rennet‐stomach	caillette
renounce	abjurer
renown	distinction
rent	loyer
renter	locataire
rent money	loyer
renunciation	abandon
repair	réformer
repay	rembourser
repeat	redire
repeatedly	plusieurs fois
repellent	affreux
repelling	affreux
repent	se repentir
repent of	regretter
replace	mettre en place de
replete	rassasié
reply	correspondre à
report	apprendre à
repose	se reposer
represent	représenter
representation	figure
representative	député
reproach	gronder
reprove	gronder
republic	république
repulse	rejeter
repulsive	affreux
reputation	réputation
repute	réputation
request	demander
require	avoir besoin de
rescue	sauver
research	recherche
resemble	rejoindre
resent	s'indigner de
resentment	rancune
reserve	commander
reservoir	bol
residence	domicile
resign	abdiquer
resign oneself	se résigner
resin	résine
resist	résister
resistance	résistance
resolution	motion
resonance‐box	boite à echo
resound	résonner
resources	moyen
respect	respecter
respective	respectif
respiration	haleine
resplendant	magnifique
respond	correspondre à
responsibility	concordance
responsible	correspondant
rest	débris
restaurant	restaurant
resting‐place	maison de repos
restrain	réprimer
restraints	bride
restrict	limiter
rest of	autre
result	provenir
resume	recommencer
resumé	abrégé
retain	réprimer
retention	garde
retire	se retirer
retired person	retraité
retirement	pension
retreat	décéder
retrenchment	abaissement
return	rente
reveal	publier
revenge	revanche
reverse	inverse
reversed	inverse
review	compte‐rendu
revise	réviser
revolt	se révolter
revolution	révolution
revolver	revolver
revue	revue
reward	récompenser
rezignation	abandon
rheumatism	rhumatisme
rhino	rhinocéros
rhinoceros	rhinocéros
rhododendron	rhododendron
rhombus	barbue
rhyme	rime
rhythm	rythme
rhythmic	rythmé
ribbon	ruban
rice	riz
rich	riche
rickety	caduc
rid	débarrasser
riddle	énigme
ride	chevaucher
ridiculous	ridicule
rifle	fusil
right‐angle	droit
right	droit
righteous	juste
righthand	droit
right away	aussitôt
right now	aussitôt
rigid	raide
rigour	austérité
rigourous	rigoureux
rill	ruisselet
rim	bord
ring	anneau
ring the bell	sonner
rinse	rincer
riot	bagarre
rip	déchirer
ripe	fait
ripen	mûrir
rise	surgir
risk	aventurer
risky	périlleux
rite	rite
rival	concourir
river	fleuve
rivet	rivet
rivulet	ruisselet
road	chemin
roam	voyager au loin
roar	gronder
roast	griller
roasted	grillé
rob	piller
robber	ravisseur
robe	robe
robes of office	ornement
robot	robot
robust	robuste
rock‐crystal	quartz
rock	balancer
rocket	fusée
rod	barre
roe	chevreuil
rogue	canaille
role	rôle
roll	petit pain
roller‐blind	store
roller	cylindre
roll up	enrouler
romantic	romantique
roof	toit
room	espace
rooster	coq
root	racine
rope	corde
rose	rose
rostrum	tribune
rot	pourrir
rotten	mauvais
rough	brut
round	reprise
roundabout	alentour
round off	arrondir
rouse	exciter
route	chemin
routine	routine
row	ramer
royal	royal
royalty	règne
rub	frotter
rubber	caoutchouc
rubbish	absurdité
rubble	abattis
rubidium	rubidium
rudder	gouvernail
rude	impoli
rudiments	abc
ruffian	Apache
ruin	abaisser
rule	commandement
ruler	dominateur
rules	réglement
rum	rhum
rumor	réputation
rumour	réputation
rump	derrière
run	fonctionner
rung	marche
running track	piste
run across	atteindre
run away	fuir
run down	abaisser
rural	rural
rush	se dépêcher
rust	rouille
rustle	sussurer
rye	seigle
régime	régime
rôle	rôle
sack	licencier
sacred	sacré
sad	affligé
saddle	selle
sadness	affliction
safe	à l'abri
safety	sécurité
sagacious	intelligent
sage	sauge
sail	voile
sailor	marin
salad	salade
salami	salami
salary	appointements
sale	abattement
salesman	marchand
sales activity	marché
saliva	bave
salivate	baver
sallow	pâle
salmon	saumon
salon	salon
salt	saler
salute	accueillir
salvage	salut
salvation	salut
same	identique
sample	spécimen
sanction	sanction
sand	arène
sandal	sandale
sandwich	sandwich
sap‐wood	aubier
sap	jus
sardine	sardine
satellite	satellite
satisfactory	satisfaisant
satisfied	content
satisfy	contenter
saturate	saturer
sauce	sauce
saucepan	casserole
saucer	soucoupe
sausage	andouille
savage	sauvage
save	préserver
saw	scier
saxophone	saxophone
say	dire
say goodbye	faire ses adieux
say goodbye to	faire ses adieux
say yes	affirmer
scald	échauder
scale	échelle
scandal	agacement
scanty	insuffisant
scar	balafre
scarce	insuffisant
scarcely	à peine
scatter	disperser
scene	scène
scenery	paysage
scent	odeur
scheme	projet
scholar	savant
school	école
school desk	pupitre
science	science
scientist	homme de science
scissors	ciseaux
scold	admonester
score	adapter
scorpion	scorpion
scoundrel	canaille
scourge	fléau
scout	reconnaissance
scrap	chiffon
scrape	effacer en grattant
scratch	gratter
scream	clameur
screw	baiser
screwdriver	tournevis
screw up	gâcher
script	scénario
scuba	scaphandre autonome
scuffle	bataille
scythe	faux
sea‐	marin
sea‐anemone	actinie
sea‐dog	phoque
sea	marin
seagull	mouette
seal	phoque
seam	joint
search	recherche
seasickness	mal de mer
seaside	bord
season	saison
seat	siège
seaweed	algue
seclude	isoler
second	deuxième
secondary	accessoire
second cousin	arrière‐cousine
secret	arcane
secretary	secrétaire
sect	secte
section	domaine
sector	secteur
secure	attacher
security	sécurité
seduce	détourner
see	rencontrer
seed	graine
seek	chercher
seem	paraître
seemingly	apparemment
seemly	convenable
see again	revoir
seize	agripper
seized with emotion	ému
seizure	apoplexie
seldom	rarement
self‐assurance	aplomb
self‐sufficiency	autarcie
self‐taught man	autodidacte
self	même
selfless	affectueux
sell	vendre
send	adresser
sender	envoyeur
send off	expédier
sensation	sentiment
sense	sens
sensible	prudent
sensitive	sensible
sentence	phrase
sentiment	sentiment
sentry	sentinelle
separate	particulier
separately	particulièrement
separation	abandon
septic	septique
serene	serein
serfdom	servage
sergeant	sergent
series	série
serious	considérable
sermon	sermon
serpent	serpent
servant	domestique
serve	être de service
service	office religieux
servitude	servage
session	session
set	appareil
settle	se résoudre à
settlement	colonie
set a trap	comploter
set a trap for	comploter
set in	aborder
seven	sept
seventeen	dix‐sept
seventy	soixante‐dix
several	plusieurs
several times	parfois
severe	austère
severity	austérité
sew	coudre
sewer	cloaque
sex	sexe
sexual love	amour charnel
sexual pleasure	volupté
shack	baraque
shackle	chaîne
shade	nuance
shadow	ombre
shaft	puits de mine
shaggy	velu
shah	schah
shake	secouer
shallow	superficiel
shallowly	rapidement
shame	pouah
shanty	baraque
shape	former
share‐capital	portefeuille d'actions
share	action
shareholder	actionnaire
share to bearer	action au porteur
shark	requin
sharp‐edged	anguleux
sharp‐toned	perçant
sharp	coupant
sharpen	affiler
sharpness	acuité
shatter	briser
shave	raser
shawl	châle
she‐ass	ânesse
she‐bear	ourse
she‐goat	chèvre
she‐wolf	louve
she	elle
sheaf	gerbe
shear	couper avec des ciseaux
shed	abri
sheep	mouton
sheet	feuille
sheet metal	fer‐blanc
shelf	étagère
shell	conque
shelter	abri
shepherd	pasteur
sheriff	shérif
shield	enseigne
shine	briller
ship	expédier
shipping share	action de compagnie maritime
shipwreck	naufrage
shirt	chemise
shiver	trembler
shock	secouer
shoe‐lace	lacet
shoe	chaussure
shoemaker	cordonnier
shoo	amener à
shoot	tirer
shoot dead	fusiller
shop	boutique
shore	bord
short‐sighted	myope
short	court
shortage	défaut
shortcoming	défaut
shorten	abréger
shortness of breath	asthme
shorts	culotte
short pants	culotte
short story	nouvelle
should	devoir
shoulder	accotement
shoulderblade	omoplate
shout	crier
shove	faire glisser
shovel	pelleter
show	manifester
showcase	vitrine
shower	douche
show window	vitrine
shrewd	avisé
shrill	perçant
shrink	se racornir
shrivel up	se racornir
shrub	arbrisseau
shrug	hausser les épaules
shuffle	mélanger
shut	fermer
shut up	serrer
shy	timide
sick	malade
sickle	serpe
side‐issue	accessoire
side	auxiliaire
sideboard	armoire
sideral	astral
sidewalk	trottoir
siege	siège
sift	tamiser
sight	air
sightless person	aveugle
sightseeing trip	excursion
sign‐board	enseigne
sign	augure
signal	signaler
signature	signature
signify	signifier
silence	repos
silent	silencieux
silhouette	silhouette
silk‐	soyeux
silk	soyeux
silken	soyeux
sill	seuil
silver	argent
similar	pareil
simple	pur
sin	commetre yne faute
since	à partir de
sincere	sincère
sincerity	sincérité
sing	chanter
singer	chanteuse
single	célibataire
sink	forer
sip	absorber
sir	monsieur
sister	sœur
sit	couver
sitting‐room	salon
situation	situation
sit down	asseoir
sit down to table	s'attabler
six	six
sixteen	seize
sixtieth	soixantième
sixty	soixante
sizable	considérable
size	ampleur
skate	patin
skeleton	squelette
skeptical	sceptique
sketch	esquisser
ski	ski
skilfulness	adresse
skill	adresse
skillful	adroit
skillfulness	adresse
skimpy	maigre
skin	fourrure
skinny	maigre
skirt	jupe
skull	crâne
sky	ciel
skyjacker	pirate de l'air
skylight	lucarne
sky blue	azur
slab	plaque
slander	calomnier
slanting	oblique
slaughter	abattre
slaughterhouse	abattoir
slave	esclave
slay	abattre
sleep	dormir
sleeping‐accommodation	dortoir
sleeping‐place	dortoir
sleeve	manche
slender	mince
slice	balafre
slip	glisser
slipper	pantoufle
slippery	glissant
slippery as an eel	glissant comme une anguille
slope	côte
slot	cannelure
slow	lent
slowly	lentement
slug	limace
sluice	écluse
slut	roulure
sly	artificieux
sly joke	blague
smack	faire du bruit avec les lèvres
small	petit
small bench	banquette
small letter	minuscule
small room	cabinet noir
smart	artificieux
smash	briser
smear	enduire
smell	flairer
smile	sourire
smith	forgeron
smock	blouse longue
smoke	fumer
smooth	plat
snail	escargot
snake	serpent
snappy	perçant
snare	piège
sneer	ricaner
sneeze	éternuer
snifter	apéritif
snore	ronfler
snorter	apéritif
snow	neiger
snowdrop	perce‐neige
snowflake	flocon de neige
so	afin de pour
soak	tremper
soap	savon
sober	sobre
soccer	foot
soccer ball	ballon
social	social
socialism	socialisme
society	club
sock	chaussette
sodium	sodium
sofa	canapé
soft	doux
soften up	forcer
soil	sol
soiled	sale
solair	ensoleillé
solder	braser
soldier	soldat
sole	pur
solemn	solennel
solicitor	avocat
solid	solide
solidarity	solidarité
solitary	pur
solution	réponse d'un problème
solve	résoudre
somber	maussade
some	une certaine quantité
somebody	un
somehow	de façon ou d'autre
someone	un
someone's	de quelqu'un
something	quelque chose
sometime	jadis
sometimes	parfois
somewhat	une certaine quantité
somewhere	quelque part
some kind of	quelconque
some one	un
son‐in‐law	beau‐fils
son	fils
sonorous	sonore
sonourous	sonore
sons and daughters	enfants
soon	bientôt
soot	suie
soothe	abattre
sorcerer	sorcier
sorcery	charme
sore	ulcère
sorrel	bai
sorrow	abattement
sort	acabit
soul	âme
sound	sonner
sound the alarm	alarmer
soup	potage
sour	acerbe
source	fontaine
south	austral
southern	austral
souvenir	souvenir
sovereign	souverain
sow	coche
so long	au revoir
so so	commeci
so that	afin de pour
so to speak	pour ainsi dire
space	espace
spaceman	astronaute
spacious	ample
spade	creuser
spades	piqûre
spanner	clef
spare	être indulgent
spare time	congé
spark	étincelle
spark plug	bougie
sparrow	moineau
speak	parler
speaker's platform	tribune
special	particulier
speciality	domaine
specially	particulièrement
species	espèce
specimen	spécimen
spectacle	spectacle
spectacles	lunettes
spectator	spectateur
speech	discours
speechless	muet
speed	hâte
speedwell	véronique
speedy	prochain
speed up	accélerer
spend	dépenser
spend the night	passer la nuit
sperm	semence
sphere	sphère
spice	assaisonner
spider	araignée
spiked	pointu
spin	filler la laine
spinach	épinard
spine	colonne vertébrale
spinster	célibataire
spiral	spirale
spirit	esprit
spit	cracher
splash	barboter
splender	pompe
splinter	écharde
split	fendre
spoil	abîmer
sponge	éponge
sponger	parasite
spontaneous	spontané
spool	bobine
spoon	cuiller
sport	sport
spot	déstination
spray gun	pistolet
spread	étendre
spread out	déployer
spring	émaner
springtime	printemps
sprinkle	joncher
spruce‐fir	épicéa
spruce	épicéa
spur	inciter
spurt	jaillir
spurt out	jaillir
spur on	inciter
spy	espion
spy on	épier
squad	compagnie
square	droit
square decametre	are
squash	potiron
squat	être accroupi
squeeze	appuyer en écrasant
squint	loucher
squire	chaperonner
squirrel	écureuil
squirt	projeter un liquide
stab	piquer
stable	ferme
stack	accumuler
stadium	étape
stage	tenue
stagnate	stagner
staid	sérieux
stain	salir
stair	marche
staircase	escalier
stairs	escalier
stake	pieu
stale	rassis
stalk	chaume
stall	écurie
stallion	cheval entier
stammer	bafouiller
stamp	timbre
stamped	affranchi
stanchion	pieu
stand	échoppe
standard	drapeau
standing on end	ébouriffé
standing together	solidaire
stand up	surgir
stand up to	affronter
staple	parenthèse
star‐	astral
star	astral
start	activer
starting point	point de contact
start off	démarrer
start out	partir
state	affirmer
statement	déclaration
statement of policy	programme
station	gare
statue	statue
stature	stature
statute	statut
stay	séjour
stay on	rester en arrière
stay over	rester
steak	bifteck
steal	d'acier
steam	vapeur
steel	acier
steep	abrupt
steer	diriger
steering‐wheel	gouvernail
steering	direction
stem	tige
stencil	modèle
step	faire les cent pas
steppe	steppe
step out	presser le pas
sterness	austérité
stevedore	arrimeur
stew	ragoût
stewardess	hôtesse de l'air
stewardship	économat
stick	s'agglutiner
stick to the pan	attacher
stiff	raide
stiffling	étouffant
still	encore
stimulate	agacer
stimulus	incitation
sting	piquer
stinginess	avarice
stingray	raie
stingy	avare
stipulation	condition
stir	affecter
stir up	agiter
stitch	coudre
stock	stock
stocking	bas
stodgy	maussade
stoke	chauffer
stomach	estomac
stone	pierre
stool	banquette
stoop	pencher
stop	halte
stopper	bouchon
stop up	boucher
storage battery	accu
storage room	réserve
store‐cupboard	buffet
store	boutique
storey	étage
stork	cigogne
storm	donner l'assaut
storming	assaut
story	étage
stove	cuisinière
stow	serrer
straight	direct
straightforward	pur
straight past	au‐delà de
straigh ahead	debout
strait	détroit
strange	étranger
stranger	inconnu
strap	courroie
strategy	stratégie
straw	paille
strawberry	fraise
strawberry tree	arbousier
streak	raie
stream	courant
strech	bander
strech out	étendre
street	rue
streetcar	tramway
strength	force
stress‐mark	accent
stress	accentuer
strew	joncher
strict	austère
stride	faire les cent pas
strike	battre
strike off	débattre
strike out	barrer
string	défiler
stringent	rigoureux
strip	bande
stripe	bande
strive for	se démener
stroke	apoplexie
stroke of apoplexy	apoplexie
stroll	promenade
stroller	promeneur
strong	fort
strongly	fortement
strontium	strontium
strop	cuir à rasoir
structure	structure
struggle	se débattre
stubborn	obstiné
student	étudiant
studio	atelier
study	étude
stuff	affaires
stumble	achopper
stupid	bébête
stupidly	stupidement
sturdy	robuste
sturgeon	esturgeon
stutter	bafouiller
sty	écurie
style	style
subdue	soumettre
subject	sujet
subjugate	soumettre
submit	soumettre
subordinate	inférieur
subscribe	s'abonner
subscriber	abonné
subscribe to	s'abonner
subscription	abonnement
subsequently	après
subsidiary subject	sujet secondaire
subsidy	subvention
substance	substance
substitute	mettre en place de
subterfuge	artifice
subtle	fin
subtract	retrancher
subtraction	soustraction
subversion	abattage
subvert	saper
subway	métro
succeed	abouter
success	prospérité
successor	descendant
such	autant
such a	comme
such as	comme
suck	sucer
suckle	allaiter
sudden	soudain
suddenly	soudainement
suffer	endurer
suffice	suffire
sufficient	suffisant
sufficiently	assez
suffix	suffixe
suffocate	étouffer
sugar	sucre
sugary	doucereux
suggest	désigner
suit	convenir
suitable	convenable
suitcase	valise
suite	clique
sulphur	soufre
sultry	étouffant
sum	montant
summarize	abréger
summary	abrégé
summer	été
summit	bout
summon	appeler
sun‐	ensoleillé
sun	ensoleillé
sunbeam	rayon de soleil
superb	grandiose
superficial	superficiel
superior	dominant
superscription	inscription
supersign	accent
superstition	superstition
supervise	surveiller
supper	dîner
supply	fournir
support	accoter
supporter	adhérent
supporters	adhérents
suppose	supposer
supposing that	supposé que
supposition	hypothèse
suppress	réprimer
sure	assuré
surely	d'abord
surface	comble
surgeon	chirurgien
surgery	chirurgie
surgical operation	opération
surly	maussade
surmise	conjecturer
surpass	dépasser
surprise	surprendre
surrender	abandon
surround	entourer
surroundings	abords
susceptibility	recevabilité
suspect	se méfier
suspenders	bretelles
suspicion	méfiance
suspicious	méfiant
sustain	accoter
sustained	continuel
swallow	avaler
swamp	marais
swan	cygne
swap	échanger
swarm	fourmiller
swear	blasphémer
swear off	abjurer
sweat	transpirer
sweep	balayer
sweet	doux
swell	gonfler
swift	prompt
swiftly	rapidement
swim	nager
swimming‐bath	piscine
swimming‐pool	piscine
swimming trunks	slip de bain
swindle	frauder
swine	cochon
swing	balancer
swirl	tourbilloner
swish	sussurer
switch	badine
swoon	s'évanouir
swotch on	activer
sycamore	érable
symbol	symbole
sympathetic	sympa
sympathy	sympathie
syndicate	syndicat
syrup	sirop
system	système
table‐cloth	nappe
table	liste
tablet	liste
tabulation	liste
tackle	aborder
tact	mesure
tactic	tactique
tactics	tactique
tail	queue
tailor	couturière
tails	habit
take	accepter
taken aback	stupéfait
take account of	faire attention à
take action	agir
take along	assembler
take an interest	s'intéresser
take away	prélever
take care	avoir soin de
take care of	se soucier de
take down	abattre
take exception to	s'indigner de
take fire	s'allumer
take in	accepter
take into account	faire attention à
take leave	faire ses adieux
take leave from	faire ses adieux
take note	constater
take off	enlever
take offence at	s'indigner de
take over	acheter
take part	participer
take refuge	se réfugier
take steps	se démener
take the place of	remplacer
taking	achat
taking over	achat
tale	récit
talent	aptitude
talisman	amulette
talk	parler
tall	haut
tame	dresser
tangerine	mandarine
tangle	imbroglio
tank	citerne
tap	forer
tape‐recorder	magnétophone
tape	bande
tapestry	tapisserie
tar	goudron
tard	perçant
target	but
tart	acerbe
tartness	aigreur
task	devoir
taskmaster	bailli
taste	goût
tasty	savoureux
tattler	babillard
tax	imposer
taxi	taxi
tax form	feuille de déclaration
tea‐pot	théière
tea	thé
teach	apprendre
teacher	institutrice
team	équipe
teapot	théière
tear	larme
tear off	cueillir
tease	agacer
teat	mamelle
technics	technique
technique	technique
teetotalism	abstension totale d'alcool
teetotaller	personne qui ne boit jamais d'alcool
telegram	télégramme
telegraph	télégraphe
telephone	téléphoner
telephone booth	cabine téléphonique
telephone kiosk	cabine téléphonique
television	télévision
tell	dire
telltale	babillard
tell a lie	mentir
temper	durcir
temperate	sobre
temperature	température
template	modèle
temple	tempe
templet	modèle
temporary	temporaire
tempt	tenter
temptation	tentation
ten	dix
tenant	locataire
tendency	aptitude
tender	adjudication
tenderness	tendresse
tend to	soigner
tension	tension
tent	tente
tented camp	camp
term	terme
terminate	cesser
terms	condition
terrace	terrasse
terrain	terrain
terrestrial	terrestre
terrible	affreux
territory	territoire
terror	terreur
test	examen
testament	testament
testicle	testicule
testify	attester
testimony	témoignage
text	texte
textile	textile
than	que
thank	remercier
thankful	reconnaissant
thankless	ingrat
thanks	remerciement
thanks to	grâce à
thank you	merci
that	que
that's all right	cela ne fait rien
that's okay	cela ne fait rien
that is	c'est‐à‐dire
that kind of	autant
that much	tant
that one	celui
that one's	de celle‐là
that way	ainsi
thaw	dégeler
the	à l'
theatre	théâtre
theatre play	pièce de théâtre
thee	te
thee and thou	tutoyer
their	leur
them	à eux
theme	composition
then	après
theocracy	théocratie
theory	théorie
there	voici
thereabout	alentour
thereabouts	alentour
thereafter	après
therefore	aussi
there are	il y a
there is	il y a
thermometer	thermomètre
these	ceci
these days	actuellement
thesis	thèse
they	ils
the Netherlands	Pays‐Bas
the Ukraine	Ukraine
the Vatican	Vatican
the day after tomorrow	après‐demain
the day before yesterday	avant‐hier
thick	dense
thicken	grossir
thigh	cuisse
thimble	dé à coudre
thin	maigre
thing	chose
things	affaires
think	être d'avis
think about	réfléchir
think ahead	anticiper
think to oneself	méditer
think well of	apprécier
third	tiers
thirst	soif
thirteen	treize
thirteenth	treizième
thirty	trente
this	ceci
thisle	chardon
this evening	ce soir
this here	ceci
this morning	ce matin
thorn	épine
thoroughgoing	radical
thou	vous
though	quoique
thought	pensée
thoughtfulness	précaution
thousand	mille
thread	fil
threat	menace
threaten	gronder
threatening	sinistre
three	trois
thresh	battre
threshold	seuil
throat	gorge
through	complètement
throw‐back	atavisme
throw	jeter
throw away	rejeter
throw off	précipiter
throw up	rejeter
thrush	grive
thrust	pousser
thumb	pouce
thunder	retenir
thus	ensuite
tick	tique
ticket‐window	guichet
ticket	billet
tickle	chatouiller
tic douloureux	névralgie faciale
tidbit	friandise
tide	marée
tidy	ordonner
tie	attacher
tie on	attacher
tie up	attacher
tiger	tigre
tight	strict
tighten	serrer
tightness of the chest	oppression
tile	carreau
till	caisse
tillage	agriculture
tilt	incliner
timber	bois
time	fois
time off	congé
timid	timide
tin	fer‐blanc
tinkle	tinter
tint	nuance
tiny	miniscule
tin plate	fer‐blanc
tip	bout
tipsy	gris
tired	fatigué
tiresome	ennuyeux
titanium	titane
title	intitulé
titmouse	mésange
to	à
toad	crapaud
toast	griller
tobacco	tabac
today	aujourd'hui
toe	doigt du pied
together	ensemble
together with	d'ailleurs
toilet	cabinet
token	preuve
tolerate	tolérer
tomato	tomate
tomb	tombe
tomorrow	demain
tomorrow evening	demain soir
tomorrow morning	demain matin
ton	tonne
tone	ton
tongs	pinces
tongue	langue
tonsil	amygdale
too	aussi
tool	instrument
tooth‐brush	brosse à dents
tooth	dent
too much	trop
top	mutiler
topic	actualité
topical	actuel
topicality	actualité
torch	torche
torment	tourmenter
torpedo	torpiller
torrent	flot
tortoise	tortue
torture	torture
total	total
total abstainer	personne qui ne boit jamais d'alcool
total abstinence	abstension totale d'alcool
touch	toucher
touching	attendrissant
touch lightly	effleurer
tourism	tourisme
tourist agency	agence de voyage
tousle	hérisser
tow	traîner
toward	à
towards	à
towel	serviette
tower	tour
town‐hall	hôtel de ville
town	localité
township	hameau
town hall	hôtel de ville
to her	à lui
to him	à lui
to it	à lui
to me	à moi
to some extent	une certaine quantité
to tell the truth	à proprement parler
to the	à l'
to thee	te
to them	à eux
to us	à nous
to you	te
trace	empreinte
track	piste
tractability	docilité
tractable	conciliant
tractor	tracteur
trade‐union	syndicat
trade	commerce
tradition	tradition
traffic	circulation
tragedy	tragédie
tragic	tragique
trailer	baladeuse
train	clique
trait	trait
trajectory	trajectoire
tram	tramway
trample on	fouler aux pieds
tranquil	calme
transfer	passer
transform	résoudre
transformation	transformation
transgress	commetre yne faute
transgression	péché
transitive	transitif
translate	traduire
transmit	adresser
transparant	limpide
transport	reporter
trap	piège
travel	aller
traveller	voyageur
travel agency	agence de voyage
tray	plateau
treacherous	traître
tread	faire les cent pas
treasure	cassette
treat	guérir
tree	arbre
tremble	trembler
tressle	établi
trial	désolation
triangle	triangle
triangular	triangulaire
tribe	tribu
tribunal	tribunal
tribute	tribut
trick	artifice
trickery	artifice
trifle	babiole
trifling	mineur
trim	garnir
trip	voyage
trite	banal
triumph	triomphe
trollop	roulure
trombone	trombone
troop	troupe
tropical	tropical
trot	trotter
trouble	problème
trough	auge
troupe	troupe
trousers	pantalon
trout	truite
truce	trêve
truck	camion
truculent	bagarreur
true	vrai
truly	en réalité
trump	atout
trumpet	trompette
truncate	mutiler
trunk	coffre
trust	se fier
trustworthy	sûr
try	peiner
tub	baquet
tube	chambreàair
tug	tirer
tummy	ventre
tumult	bagarre
tuna‐fish	thon
tuna	thon
tune	adapter
tungsten	tungstène
tunnel	tunnel
tunny	thon
tup	bélier
turkey	dindon
turn	dévier
turnip	navet
turnover	opération de caisse
turn around	tourner
turn away	détourner
turn on	activer
turn over	renverser
turn round	tourner
turtle‐dove	tourterelle
tussle	se bagarrer
twelfth	douzième
twelve	douze
twentieth	vingtième
twenty	vingt
twig	rameau
twin	jumeau
twine	natter
twins	jumeaux
twist	tordre
twitter	gazouiller
two	deux
two hundred	deux cents
type	dactylographier
typeset	composer
typewriter	machine à écrire
typhus	typhus
typical	représentatif
typist	dactylographe
tyrant	tyran
udder	pis
ugly	mauvais
ulcer	ulcère
ultimately	enfin
umbrella	parapluie
umpire	arbitre
uncertain	aléatoire
uncle	oncle
unclean	sale
uncouple	détacher
uncover	découvrir
under	sous
underground	métro
undermine	saper
underneath	dessous
underpants	caleçon
understand	comprendre
understanding	abord
undertake	entreprendre
undoubtedly	sans doute
undress	déshabiller
undulate	onduler
unfaithful	traître
unfortunately	malheureusement
ungrateful	ingrat
unhappy	malheureux
uniform	uniforme
unimportant	mineur
unintelligible	abracadabrant
unique	unique
unit	unité
unite	accoupler
unity	unité
universe	univers
university	université
unkind	maussade
unknown	ignoré
unload	décharger
unlock	ouvrir
unmarried	célibataire
unmarried woman	célibataire
unpleasant	maussade
unripe	prématuré
unroll	développer
unsocial	antisocial
unsound	véreux
unthankful	ingrat
untidy	ébouriffé
untie	détacher
until	à
untroubled	serein
up‐to‐date	actuel
upholster	rembourrer
upon	de
upper‐arm	bras supérieur
upper	supérieur
upper arm	bras supérieur
upset	stupéfait
upstairs	dessus
uranium	uranium
urchin	bambin
urge	inciter
urgency	impulsion
urinate	faire pipi
us	à nous
use	appliquer
used to	accoutumé
useful	utile
useless	inutile
use up	consommer
usual	accoutumé
usually	ordinairement
uterus	utérus
utilize	exploiter
utter	répandre
vacant	vague
vacation	vacances
vaccinate	vacciner
vacuum‐cleaner	aspirateur
vacuum cleaner	aspirateur
vagina	vagin
vain	abortif
valiant	courageux
valid	valable
valise	valise
valley	vallée
valuable	cher
value	mérite
valve	abattant
vanity	futilité
vapor	vapeur
vapour	vapeur
varied	divers
variety entertainment	variété
various	divers
varnish	vernis
vary	différer
vase	pot
vast	ample
vat	baquet
vault	voûte
vaulted ceiling	voûte
veal	veau
vegetable	légume
vegetate	végéter
vehicle	bagnole
veil	voiler
vein	veine
velvet	velours
vend	vendre
vengeance	revanche
ventilate	aérer
ventilator	aérateur
venture	oser entreprendre
verb	verbe
verbatim	à proprement parler
verdict	sentence
verge	accotement
verge of a road	accotement
verify	surveiller
verse	strophe
vertebra	vertèbre
vertical	vertical
very	bien
very much	bien
very well	à merveille
vessel	bac
vest	maillot de corps
vex	chagriner
vibrate	vibrer
vibration	frisson
vicar	curé
vice	vice
vicious	méchant
victim	victime
video‐recorder	magnétoscope
video‐tape	bande vidéo
video recorder	magnétoscope
view	air
viewpoint	point de vue
vigour	activité
viking	Viking
vile	abject
villa	villa
village	localité
villager	villageois
vine	vignoble
vinegar	vinaigre
violate	attenter
violet	violet
violin	violon
viper	couleuvre
virgin	vierge
virginal	vierge
virus	virus
visa	visa
visible	apparant
vision	vision
visit	visiter
visitor	visiteur
visit regularly	fréquenter
visé	visa
vixen	renarde
vocabulary	dictionnaire
vodka	vodka
voice	voix
void	vide
volcano	volcan
volley	flot
voltage	tension
volume	volume
vomit	rejeter
vow	vœu
vowel	voyelle
voyage	voyage
vulgar	trivial
vulture	vautour
wadding	ouate
wade	marcher dans l'eau
waffle	gaufre
wage	appointements
wager	parier
wages	appointements
wage war	guerroyer
waggon	wagon
wail	se lamenter
wainscot	lambris
waist	taille
waistcoat	gilet
waistline	taille
wait	attendre
waiter	garçon
waiting‐room	antichambre
waiting room	antichambre
wait for	attendre
wake	réveiller
wake up	réveiller
walk	marcher
walk back	reculer
walk backwards	reculer
wall	mur
wallet	porte‐monnaie
wallflower	giroflée des murailles
wall covering	tapisserie
walnut‐tree	noyer
walnut	noix
wand	badine
wander	voyager au loin
wander about	voyager au loin
wane	diminuer
want	désir
war	guerre
ward off	s'abriter
wares	marchandise
warlock	sorcier
warm	cordial
warmly	chaudement
warn	alerter
warning	recommandation
warrant	assurer
warrior	militaire
wart	verrue
wash	laver
washing‐bear	raton laveur
wasp	guêpe
waste	dissiper
watch	montre
watchmaker	horloger
watch out for	surveiller
watch over	garder
water‐	aquatique
water‐colour	aquarelle
water‐melon	melon d'eau
water	aquatique
waterfall	cascade
watering‐can	arrosoir
waterlily	nymphéa
wave	onde
waver	barguigner
wave about	agiter
wax	cire
way	chemin
way out	issue
we	nous
we