Afrika	Africa
Armenien	Armenia
Asien	Asia
Atlanten	Atlantic
Australien	Australia
Bajern	Bavaria
Belgien	Belgium
Bibel	Bible
Bottenviken	Gulf of Bothnia
Bottniska viken	Gulf of Bothnia
Brasilien	Brazil
Brittannien	Britain
Bulgarien	Bulgaria
Dalarna	Dalecarlia
Danmark	Denmark
Egypten	Egypt
England	England
Estland	Estonia
Europa	Europa
Finland	Finland
Flandern	Flanders
Frankrike	France
Förenta staterna	United States of America
Grekland	Greece
Gud	God
Holland	Holland
Indien	India
Irland	Ireland
Ishavet	Arctic Ocean
Island	Iceland
Italien	Italy
Jon Blund	the Dustman
Kaspiska havet	Caspian Sea
Kristi himmelsfärdsdag	Ascension Day
Kristus	Christ
Köpenhamn	Copenhagen
Lappland	Lapland
Lettland	Latvia
Medelhavet	Mediterranean
Mongoliet	Mongolia
Nederländerna	Holland
Nordamerika	North America
Norden	Scandinavia
Nordpolen	Arctic
Nordsjön	North Sea
Norge	Norway
Polen	Poland
Rhen	Rhine
Rom	Rome
Rumänien	Romania
Ryssland	Russia
Rödluva	Little Red Ridinghood
Schweiz	Switzerland
Siberien	Siberia
Sicilien	Sicily
Skandinavien	Scandinavia
Skottland	Scotland
Snövit	Little Snow White
Spanien	Spain
Spetsbergen	Spitsbergen
Storbrittannien	Britain
Sverige	Sweden
Sydamerika	South America
Sydpolen	Antarctic
Söderhavet	Pacific
TV	television
Turkiet	Turkey
Tyskland	Germany
‐bar	‐able
‐lös	‐less
USA	United States of America
Ukraina	Ukraine
Ungern	Hungary
Västindien	West Indies
Yttersta östern	Far East
abbedissa	abbess
abborre	bass
abbot	abbot
abbotskloster	abbey
abnorm	deformed
abonnemang	subscription
abonnent	subscriber
abonnera	subscribe
absolutist	teetotaller
accent	accent
accept	acceptance
accis	excise
ack	ah
ackja	reindeer‐sledge
ackompanjemang	accompaniment
ackord	chord
ackurat	accurate
ackusativ	accusative
ackuschör	obstetrician
ackuschörska	midwife
ackvisition	acquirement
addition	addition
adel	nobility
aderton	eighteen
adertonde	eighteenth
adjektiv	adjective
adjunkt	curate
adjutant	adjutant
adjö	adieu
adjö så länge	bye
adlig	of noble birth
administratör	manager
adress	address
adressant	sender
adressera	address
adresskalender	address list
adresskort	dispatch note
adresslapp	dispatch note
adverb	adverb
affektation	affectation
affisch	notice
affischera	placard
affär	affair
affärsförbindelse	business relation
affärsgata	shopping street
affärshus	company
affärsman	businessman
affärsvän	business friend
afrikan	African
afrikansk	African
afton	evening
aftonbön	night prayers
aftonmåltid	evening meal
aga	castigation
agent	agent
agentur	agency
agg	discontent
agitation	agitation
agn	bait
aja sig	groan
akademi	academy
aktie	share
aktiv	active
aktris	actress
aktör	actor
akvarell	water‐colour
akvavit	brandy
akvedukt	aqueduct
al	alder
alarm	alarm
alarmere	alarm
aldrig	never
alfabet	alphabet
alg	alga
alkohol	alcohol
allaredan	already
alldaglig	daily
alldeles	at all
alldeles icke	not at all
allegorisk	allegoric
allehanda	all
allestädes	all about
allhelgonadag	All Hallows
allians	alliance
allmakt	omnipotence
allmogespråk	dialect
allmosa	alms
allmän	public
allmänhet	generality
allrådande	almighty
allsmäktig	almighty
alls icke	not at all
allt	universe
alltefter	according as
alltemellanåt	several times
alltför	too
alltid	always
alltifrån	from
allting	all
alludera	allude
allvarlig	earnest
allvetande	all‐knowing
allé	avenue
alm	elm
almanacka	almanac
alster	product
alstra	afford
alstring	production
altan	balcony
altare	altar
alternativ	alternative
altröst	contralto
altstämma	contralto
alun	alum
amatör	amateur
ambition	ambition
ambitiös	ambitious
amerikan	American
amerikansk	American
amfiteatro	amphitheatre
amiral	admiral
ammunition	munition
amt	district
analogi	analogy
analys	analysis
anamma	get
ananas	pineapple
anarkist	anarchist
anatomisk	anatomical
anbefalla	commend
anbefallning	recommendation
anblick	appearance
and	duck
anda	spirit
andas	breathe
ande	mind
andel	part
andhämtning	respiration
andlig	mental
andlös	breathless
andning	respiration
andra	second
andre	second
anekdot	anecdote
anemi	anaemia
anfall	access
anfalla	assault
anföra	cite
anförande	citation
anförare	boss
anföringstecken	inverted comma
anförvant	relative
angenäm	agreeable
angrepp	access
angripare	aggressor
angående	about
anhang	adherents
anhörig	affined
anhålla	arrest
aning	suspicion
anis	anise
anka	duck
ankare	anchor
ankel	ankle
anklaga	accuse
anklagelse	accusal
ankomst	arrival
anlete	face
anlopp	crush
anmoda	ask
anmodan	request
anmäla	advertise
anmälan	ad
anmärkningsvärd	noteworthy
annalkande	approach
annan	other
annanstans	elsewhere
annons	ad
annonsera	advertise
annorlunda	differently
annorstädes	elsewhere
annotationsbok	notebook
annotera	note
anonym	anonymous
anropa	appeal to
ansa	attend
anse	account
ansedd	dear
anseende	appearance
ansikte	face
ansjovis	anchovy
anslag	notice
anslagstavia	bill‐board
ansluta	combine
anslående	agreeable
anspela	allude
anspelning	allusion
anstöt	offence
anstötlig	aggravating
anstånd	adjournment
ansvar	responsibility
ansvarig	accountable
ansöka	ask
anta	guess
antagande	suspicion
antaglig	suspicious
antal	amount
anteckna	note
antikvitetshandlare	antique dealer
antända	kindle
använda	employ
apa	ape
apel	apple‐tree
apelsin	orange
apostel	apostle
apotek	chemist's shop
apotekare	chemist
apparat	apparatus
appell	appeal
applåd	acclaim
applådera	acclaim
aprikos	apricot
april	April
apropå	by the way
aptit	appetite
arab	Arab
arabisk	Arabian
arbeställa	abjure
arbeta	work
arbetare	hand
arbete	job
arbeterska	female laborer
arbetsam	diligent
arbetsgivare	employer
arbetslös	unemployed
arbetstagare	employee
areal	area
arg	angry
aritmetik	arithmetic
arkipelag	archipelago
arkitekt	architect
arkiv	archive
arkivarie	archivist
arm	arm
armband	bracelet
armbandsur	watch
armbåge	elbow
armhåla	armpit
armod	poverty
armé	army
arrangera	arrange
arrendator	farmer
arrende	farm
arrestera	arrest
art	character
artificiell	artificial
artig	courteous
artighet	politeness
artikel	article
artilleri	artillery
artist	artist
arton	eighteen
artonde	eighteenth
artär	artery
arv	inheritance
arvinge	heir
arvode	salary
as	cadaver
asiat	Asian
asiatisk	Asian
ask	ash
aska	ash
asketisk	ascetic
askkopp	ashtray
asp	aspen
assurans	insurance
aster	aster
astronomi	astronomy
ateism	atheism
ateist	atheist
ateljé	atelier
atlas	atlas
atmosfär	atmosphere
atom	atom
atombomb	atom bomb
atomkraft	atomic energy
attack	access
attest	certificate
attestera	attest
attraktion	attraction
auditorium	auditory
augusti	August
auktion	auction
auktor	author
australier	Australian
australisk	Australian
autentisk	authentic
automat	automoton
automatisk	automatic
av	from
avbetala	pay off
avbetalning	acquittal
avbryta	interrupt
avgiftsfri	free
avgrund	abyss
avgränsa	abridge
avgud	idol
avhämta	fetch
avhängig	dependent
avi	ad
avla	cultivate
avleverera	deliver
avlida	die
avliden	dead
avliva	kill
avlopp	sewer
avlöning	salary
avrätta	kill
avsked	farewell
avskicka	dismiss
avskrift	copy
avsky	abhor
avstånd	distance
avtagsväg	by‐way
avträde	toilet
avund	envy
avundas	envy
avundsam	envious
avväg	by‐way
avyttra	dispose of
av adel	of noble birth
av misstag	by mistake
av siden	silk
av trä	wooden
axel	axis
babian	baboon
babord	port side
baby	baby
backe	hill
bad	bath
baddräkt	bathing suit
badhytt	bathing box
badkar	bath
badort	spa
badstuga	sauna
bagage	baggage
bagagevagn	luggage‐van
bagarbod	baker's shop
bagare	baker
bageri	bakery
bagge	ram
bajersk	Bavarian
bajonett	bayonet
bajrare	Bavarian
bak	back
baka	bake
bakdanta	slander
bakefter	behind
baklykta	rear‐lamp
baktala	slander
bakterie	bacterium
baktill	behind
bakåt	backward
bal	ball
balans	equilibrium
balett	ballet
balk	beam
balkong	balcony
ballast	ballast
ballong	balloon
balsam	balm
baltisk	Baltic
balustrad	balustrade
bambu	bamboo
bana	path
banal	commonplace
banan	banana
band	band
bandage	bandage
bandit	bandit
baneman	murderer
bank	bank
banka	beat
bankett	banquet
bankir	bank clerk
bankrutt	bankruptcy
bar	bare
bara	exclusively
barack	barrack
barbar	barbarian
bark	bark
barlast	ballast
barnbarn	grandchild
barnlös	childless
barnmorska	midwife
barnsängskvinna	lying‐in woman
barometer	barometer
baron	baron
baronessa	baroness
barrträd	conifer
basera	base
bassäng	basin
bast	bast
bastu	sauna
batalj	action
bataljon	battalion
batteri	accumulator
beakta	advert
bebåda	advertise
bebådelsedag	Annunciation
becksvart	pitch black
bedja	ask
bedra	cheat
bedraga	cheat
bedragare	cheat
bedrägeri	swindle
bedräglig	deceitful
bedröva	afflict
bedrövelse	grief
bedöma	judge
befalla	command
befallning	command
befinna sig	be found
befolkning	population
befordra	advance
befordran	advancement
befria	release
befrämja	favor
befäl	command
befälhavare	commander
befängd	foolish
befästa	attach
begagna	employ
begagnande	use
begrava	bury
begravning	burial
begrepp	notion
begripa	understand
begriplig	understandable
begrunda	think
begränsa	abridge
begynna	begin
begynnelse	beginning
begär	avidity
begära	covet
begäran	avidity
begärlig	acquisitive
begåvning	aptitude
behag	pleasure
behaga	please
behagfull	charming
behaglig	agreeable
behandla	deal with
behandling	treatment
behjälplig	accommodating
behjärtad	brave
behov	need
behärska sig	control oneself
behöva	need
behövande	miserable
behövlig	necessary
behå	bra
behåll	safety
behålla	conserve
behållare	tank
bejaka	affirm
bekant	well‐known
bekantgörande	advice
beklaglig	regrettable
beklädnad	clothes
bekomma	get
bekosta	bear the cost of
bekväm	comfortable
bekänna	acknowledge
bekännelse	acknowledgement
belgier	Belgian
belgisk	Belgian
belopp	amount
belysa	illuminate
belysning	lighting
belägra	besiege
belägring	siege
belöna	compensate
belöning	compensation
belåten	contented
bemärkelsedag	meaning
bemödande	attempt
ben	leg
benkläder	pants
benrangel	skeleton
bensin	gasolene
bensinstation	filling station
benämna	call
benåda	forgive
benådning	absolution
bepröva	examine
bereda	prepare
beredelse	preparation
berg	mountain chain
bergklyfta	ravine
bergskred	avalanche
berlinsk	Berlin
beroende	dependent
berudsad	drunk
beryktad	famous
beräkna	calculate
beräkning	calculation
berätta	narrate
berättelse	account
beröm	praise
berömd	famous
berömlig	commendable
berömma	commend
beröra	touch
beröring	touch
besegra	defeat
besegrare	victor
besiktiga	inspect
besiktningsman	inspector
besinna	think
besittning	property
besk	acerbic
besked	answer
beskriva	describe
beskrivning	account
beskydd	protection
beskydda	protect
beskyddare	patron
beskylla	accuse
beskyllning	accusal
beskärm	protection
besluta	decide
besläktad	affined
best	animal
bestjäla	rob
bestraffa	punish
besvikelse	disappointment
besättning	crew
besök	visit
besökande	caller
betala	pay
betalning	payment
betalningsbevis	receipt
beteckna	imply
beteende	behavior
bete sig	behave
betjäningsavgift	tip
betjänt	boy
betong	concrete
betrakta	account
betrygga	affirm
beträffa	concern
bett	teeth
betyda	imply
betydelse	meaning
betyga	attest
betäcka	cover
betänka	think
beundra	admire
beundran	admiration
beundrare	admirer
bevis	proof
bevisa	prove
bevista	attend
beväpna	arm
be om ursäkt	ask forgiveness
bi	bee
bibel	bible
bibliotek	library
bibliotekarie	librarian
bifall	acclaim
biff	steak
biffstek	steak
bifoga	add
bikt	confession
bikta	confess
bikupa	beehive
bil	car
bila	axe
bild	image
bilda	form
bildhuggare	sculptor
bildstod	statue
bilist	motorist
biljard	billiards
biljett	bill
billig	cheap
billyftare	jack
binamn	byname
binda	bind
biodlare	apiarist
biograf	cinema
biskop	bishop
bistånd	aid
bit	bit
bita	bite
biträda	accomodate
biträde	aid
bitter	acerbic
bittida	early
bjuda	invite
bjudning	invitation
bjälke	beam
björk	birch
björn	bear
björnbär	blackberry
björnhona	she‐bear
björninna	she‐bear
blad	leaf
blanda	blend
bli	become
blid	advantageous
blind	blind
bliva	become
blixt	lightning
blixtlås	zipper
blixttåg	fast train
bli förälskad i	fall in love with
bli kär i	fall in love with
block	block
blockad	blockade
blockera	block
blod	blood
blodbrist	anaemia
blodigel	leech
blodsfrånde	relative
blodsförvant	relative
blomkål	cauliflower
blomma	bloom
blomster	bloom
blond	blond
bloss	torch
blott	exclusively
blus	blouse
bly	lead
blyertspenna	pencil
blyg	abashed
blygas	be ashamed
blyghet	bashfulness
blygsam	modest
blygsel	shame
bläck	ink
bläckhorn	well
bläddra	bladder
blända	dazzle
blöda	bleed
blå	blue
blåbär	blueberry
blåklint	cornflower
blåsa	blow
bo	dwell
bobba	cockroach
bock	he‐goat
boddisk	counter
bohag	furniture
bok	beech
bokförare	book‐keeper
bokhandlare	bookseller
bokhållare	book‐keeper
bokskåp	bookcase
bokslut	balance sheet
bokstav	letter
boll	ball
bom	barrier
bomb	bomb
bomull	cotton
bonde	farmer
bondgård	estate
boning	abode
bord	table
bordduk	table‐cloth
bordell	brothel
borg	castle
borgmästare	mayor
borr	bore
borra	bore
borsta	brush
borste	brush
bostad	abode
botanik	botany
botten	bottom
bottenvåning	ground‐floor
boxa	box
bo ihop	cohabit
bra	good
brasiliansk	Brazilian
braxen	bream
bredd	width
bredvid	beside
brev	letter
brevbärare	postman
brevkort	postcard
brevlåda	letterbox
brigad	brigade
brinna	burn
bris	breeze
brist	absence
britt	Briton
brittisk	British
bro	bridge
broder	brother
broms	brake
bromsa	brake
brons	bronze
bror	brother
brorsdotter	niece
brorson	nephew
brorsson	nephew
brosch	brooch
broschyr	leaflet
brottslig	criminal
brottsling	criminal
brud	bride
brudgum	bridegroom
bruk	use
bruka	employ
bruklig	accustomed
brun	brown
brunn	spa
brydd	abashed
bryderi	bashfulness
brysselkål	Brussels‐sprouts
bryta	break
brytbar	breakable
bräcklig	breakable
bräde	board
brännmaterial	fuel
brännvin	brandy
brännässla	nettle
bränsle	fuel
bröd	bread
bröllop	wedding
bröst	bosom
bråk	ado
buffel	buffalo
buk	abdomen
bulevard	boulevard
buljong	bouillon
bulle	roll
buller	ado
bulletin	bulletin
bullra	make a noise
bur	cage
buske	bush
buss	friend
butelj	bottle
butik	boutique
butiksinnehavare	shopkeeper
by	village
bygdemål	dialect
bygga	build
byggmästare	architect
byggnad	building
byggnadstomt	building‐plot
byrå	office
bytta	bucket
byx	pants
byxa	pants
byxor	pants
bäck	stream
bädd	bed
bägare	goblet
bägge	both
bälte	belt
bänk	bench
bär	berry
bära	carry
bärare	porter
bäst	best
bättra	improve
bättre	better
bäva	quiver
bäver	beaver
bödel	hangman
bölja	undulate
bön	request
böna	bean
böra	have to
börd	birth
börja	begin
början	beginning
börs	stock exchange
böter	fine
båda	both
båge	arc
båt	boat
båtledes	by ship
ceder	cedar
cedere	cede
cell	cell
cement	cement
censur	censor
censurera	censor
center	centre
centimeter	centimetre
central	central
ceremoni	ceremony
ceremoniell	formal
cession	bankruptcy
champagne	champagne
champignon	mushroom
chaufför	chauffeur
check	check
checkbok	cheque‐book
chef	boss
choklad	chocolate
cigarr	cigar
cigarrett	cigarette
cirka	about
cirkel	circle
cirkus	circus
citat	citation
citera	cite
citron	lemon
civilstånd	civil status
cykel	bike
cyklon	cyclone
cylinder	cylinder
cynisk	cynical
cypress	cypres
dadel	date
dadelpalm	date palm
dag	day
dagblad	daily paper
dagg	dew
dagning	dawn
dagsböter	fine
dal	valley
dala	ascend
dallra	quiver
dam	lady
damm	dike
dammsugare	vacuum cleaner
dana	form
dans	dance
dansa	dance
dansk	Danish
dansös	dancer
darra	quiver
datamaskin	computer
datera	date
dator	computer
datum	date
december	December
deg	dough
dekan	blanket
deklamera	declaim
dekret	decree
del	part
dela	divide
delta	delta
dentist	dentist
departementschef	minister
deponera	deposit
deprimerad	depressed
desinficera	disinfect
desperat	desperate
despotisk	despotic
desslikes	still
destillera	distil
detalj	detail
detektiv	detective
det var synd	alas
devis	motto
dialekt	dialect
diamant	diamond
diarium	diary
diarré	diarrhoea
diet	diet
diger	bold
dikt	poem
diktare	poet
diktera	dictate
dimma	fog
dimmig	fuzzy
diplom	diploma
direktion	direction
direktör	director
disciplin	discipline
disig	fuzzy
diskont	discount
diskret	discrete
diskutera	discuss
distans	distance
distrikt	district
dit	that way
djup	deep
djuphet	depth
djuplek	depth
djur	animal
djurisk	animal
djävul	devil
docka	doll
doft	odor
dofta	give off an odour
dogm	dogma
dok	veil
doktor	doctor
dokument	document
dold	hidden
dolk	dagger
dolsk	false
dom	judgment
domare	judge
dop	baptism
dosa	box
dotter	daughter
dotterdotter	granddaughter
dotterson	grandson
dra	drag
drabba	beat
draga	drag
drake	dragon
dram	drama
drama	drama
dregel	saliva
dregla	salivate
dricks	tip
drickspengar	tip
drink	cocktail
drinkare	boozer
driva	chase
dromedar	dromedary
droppa	drip
droppe	drip
droskbil	taxi
drottning	queen
drucken	drunk
drukna	drown
druva	grape
dryck	beverage
dryckenskap	drunkenness
dräktig	pregnant
dräng	boy
dränka	drown
dräpa	kill
dröm	dream
drömma	dream
dråp	murder
dråpare	murderer
dubbel	double
dubblera	double
duk	table‐cloth
dum	addled
dumbom	fool
dumhuvud	fool
dunkelhet	darkness
dunst	steam
dunstkrets	atmosphere
duo	pair
dusch	shower
duscha	shower
dussin	dozen
duva	dove
dvärg	dwarf
dy	mud
dyka	dive
dyna	cushion
dynamit	dynamite
dynga	fertilizer
dyr	dear
dyrbar	dear
däld	valley
dö	die
död	dead
dödlig	deadly
döma	judge
döpa	baptize
döpelse	baptism
dörr	door
dörvakt	porter
dörvaktare	porter
döv	deaf
dövstum	deaf and dumb
dåd	accomplishment
dålig	bad
dån	ado
dåraktig	crazy
dåre	lunatic
ebb	low tide
ed	oath
effekt	effect
efter	from
efterbilda	imitate
eftermiddag	afternoon
efternamn	surname
efterrätt	dessert
egendom	possession
egendomlig	odd
egenskap	property
ehuru	though
ehuruväl	though
ej	not
ek	oak
eko	echo
ekollon	acorn
ekonomi	economy
ekorre	squirrel
ekvator	equator
elastisk	elastic
eld	fire
elefant	elephant
elektricitet	electricity
elektrisk	electric
element	element
elementär	elemental
elfenben	ivory
elfte	eleventh
elva	eleven
emblem	emblem
emellan	among
emellanåt	several times
emma	armchair
emot	across from
en	one
ena	join
encyklopedi	encyclopaedia
endast	exclusively
energi	energy
engagera	employ
engelsk	English
engelsman	Englishman
enhet	unity
enplansvilla	bungalow
ensam	alone
ensamstående	living alone
entonig	monotonous
entré	access
entusiasm	alacrity
episod	episode
epok	age
era	era
erkänna	acknowledge
erlägga	pay
ernå	accomplish
erövra	conquer
eskimå	Eskimo
eskort	escort
etisk	ethical
ett	one
ettrig	poisonous
ett hundra	hundred
ett tusen	thousand
eunuck	eunuch
europeisk	European
europé	European
examen	investigation
exempel	example
exemplar	copy
existens	existence
explikation	account
explodera	explode
exponera	exhibit
exposition	exhibition
extas	ecstasy
extra	additional
fabrik	factory
fack	branch
fackla	torch
fader	father
faderlös	fatherless
faktisk	actual
faktum	fact
faktura	account
fakultet	faculty
falk	falcon
falla	drop
fallissemang	bankruptcy
fallskärm	parachute
falsk	false
familj	family
famna	embrace
fan	devil
fanatisk	fanatical
fantasi	fantasy
far	father
fara	danger
farbroder	uncle
farbror	uncle
farfader	grandfather
farfar	grandfather
farföräldrar	grandparents
farlig	dangerous
farmor	grandmother
fars	gag
fart	speed
fartyg	ship
fasad	façade
fasan	pheasant
faster	aunt
fastland	continent
fastän	though
fat	barrel
fatta	get
fattig	miserable
fattigdom	poverty
fattlig	understandable
feber	ague
februar	February
fel	aberration
fela	err
fem	five
femte	fifth
femti	fifty
femtio	fifty
femton	fifteen
femtonde	fifteenth
fena	fin
fenomen	phenomenon
ferier	vacation
fernissa	varnish
fest	celebration
festa	celebrate
fet	bold
fett	fat
fiber	fiber
ficka	pocket
fickkniv	pen‐knife
fiende	adversary
fiendskap	enmity
fientlig	adverse
fiffig	clever
figur	figure
fikon	fig
fil	file
fila	file
filosof	philosopher
filt	felt
filtrera	filter
finansiell	financial
finger	finger
finna	find
finne	Finn
finsk	Finnish
fira födelsedagen	celebrating one's birthday
fisk	fish
fiska	fish
fiskare	fisherman
fiskmås	seagull
fiskmåse	seagull
fjord	fjord
fjorton	fourteen
fjortonde	fourteenth
fjäder	feather
fjäll	scale
fjärde	fourth
fjäril	butterfly
flack	even
flagg	banner
flagga	banner
flamländare	Flemming
flamma	flame
flanell	flannel
flank	side
flaska	bottle
flicka	mend
flod	high tide
flodhäst	hippo
flotta	fleet
flotte	raft
fluga	fly
fly	flee
flyga	fly
flygfält	aerodrome
flyghamn	airport
flygmaskin	aeroplane
flygplan	aircraft
flykt	flight
flyta	float
flytande	fluent
flytta	move
flyttbil	furniture van
flyttning	removal
fläck	blot
fläder	elder
flädermus	bat
fläkta	blow
fläsk	bacon
flöde	river
flöjt	flute
folk	folk
folkmål	dialect
folkvälde	democracy
fond	fund
fontän	fountain
fordon	vehicle
forell	trout
forma	form
formel	formula
formell	formal
formera	form
formulär	blank
forsla	transport
forvänta	abide
fosfor	phosphorus
fotfolk	infantry
fotgängare	pedestrian
fotogen	paraffin‐oil
fotograf	photographer
fotografera	photograph
fotografi	photography
fotografiapparat	camera
fotsula	sole
fradga	foam
frakt	burden
frakta	transport
framgång	achievement
framtid	future
frans	frindge
fransk	French
franska	French
fransman	Frenchman
fransyska	Frenchwoman
fred	peace
freda	protect
fredag	Friday
frejdad	famous
fria	release
friherre	baron
frihet	freedom
frimurare	freemason
frimärke	stamp
fris	Frisian
fristående	detached
fristående hus	detached house
frisör	barber
frost	freezing cold
fru	lady
frukt	fruit
fruktan	agony
fruktbar	fertile
fruktträd	fruit‐tree
frysa	freeze
fräck	impertinent
frälsningsamé	Salvation Army
främling	foreigner
främmande	alien
frände	relative
frö	seed
fröjd	fun
fröjda	be glad
fråga	ask
frågvis	agog
från	from
frånskild	divorced
frånvarande	absent
frånvaro	absence
fråvarande	absent
fuktig	moist
ful	nasty
full	drunk
fullborda	accomodate
fullvuxen	adult
fur	pine
fura	pine
furste	prince
furstendöme	principality
furstinna	princess
furstlig	regal
fylla	fill
fylla år	celebrating one's birthday
fyr	lighthouse
fyra	four
fyrhörning	quadrangle
fyrsprång	gallop
fyrti	forty
fyrtio	forty
fyrtorn	lighthouse
fysik	physics
fädernesland	fatherland
fällkniv	pen‐knife
fält	field
fältflaska	canteen
fängelse	jail
färd	journey
färdas	travel
färdig	finished
färg	dye
färga	paint
färglös	achromatic
färja	ferry
fästa	attach
fästman	fiancé
fästmö	bride
födelse	birth
födelsedag	birthday
födelseort	cradle
följa	follow
fönster	window
för	for
föra	conduct
förakt	contempt
förakta	despise
föranleda	activate
förarga	aggravate
förargelse	offence
förband	bandage
förbanna	curse
förbereda	prepare
förberedelse	preparation
förbli	remain
förblinda	dazzle
förbliva	remain
förblända	dazzle
förbruka	use up
förbrytare	criminal
förbrytelse	crime
förbränna	burn down
fördel	advantage
fördelaktig	advantageous
fördom	prejudice
fördubbla	double
fördämning	dike
fördölja	conceal
fördöma	curse
förebild	example
förebrå	blame
förebråelse	reproach
föredöme	example
förenkla	simplify
förevita	blame
förevändning	pretext
författare	author
förfäringssätt	procedure
förfärlig	alarmed
förfölja	chase
förföljande	persecution
förföljelse	persecution
förföra	entice
förförelse	temptation
förgasare	carburettor
förgifta	poison
förgätmigej	forget‐me‐not
förgäves	in vain
förgången	last
förgås	perish
förhindra	bar
förhoppning	hope
förhänge	curtain
förhållande	relation
förinta	destroy
förjaga	chase away
förklara	declare
förklaring	declaration
förklarlig	accountable
förkylning	cold
förlama	paralyse
förleda	entice
förlora	lose
förlova sig	become engaged
förlova sig med	become engaged with
förlovning	betrothal
förlust	loss
förlägen	abashed
förlägenhet	bashfulness
förläggare	publisher
förlänga	lengthen
förlåt	excuse me
förlåta	forgive
förlåtelse	absolution
förnamn	first name
förnedra	abase
förneka	deny
förnärma	abuse
förnärmelse	abuse
förnödenhet	need
förolämpning	abuse
förord	recommendation
förorda	commend
förorena	soil
förorsaka	activate
förort	suburb
förpakta	farm out
förplikta	compel
förryckt	crazy
förrädisk	treacherous
förrän	before
förråda	betray
församla	collect
församling	assemblage
försiktig	careful
förskräcklig	abysmal
förslag	account
första	first
förstad	suburb
förstora	aggrandize
förstöra	destroy
försvar	defence
försvara	defend
försvinna	disappear
försäkra	insure
försäkring	insurance
försälja	dispose of
försäljning	sale
försämra	blow up
försök	experiment
försöka	attempt
förtal	backbiting
förtala	slander
förtjäna	earn
förtretlig	bleak
förtroende	confidence
förtrytelse	offence
förtvivlad	desperate
förtvivlan	despair
förundran	astonishment
förutan	without
förvalta	administer
förvaltare	manager
förvandla	alter
förvara	conserve
förvaringsställe	box‐room
förvillelse	aberration
förväntan	expectation
förvärra	blow up
förvärv	accession
förvärva	achieve
förväxla	change
förvåna	amaze
förvåna sig	marvel
förvåning	astonishment
föräldrar	parents
förälska sig i	fall in love with
förändra	change
förändras	alter
förändring	about‐face
förära	adore
förödmjuka	abase
förödmjukelse	abasement
förölämpa	abuse
fösa	chase
få	get
fågel	bird
fåne	idiot
fånga	capture
fångst	prey
får	sheep
fårkött	mutton
gadd	sting
gaffel	fork
gagn	advantage
gagna	avail
galen	crazy
galenskap	craziness
galla	bile
galleri	gallery
galning	lunatic
galopp	gallop
galosch	galosh
gam	vulture
gammal	old
gammaldags	old‐fashioned
gammalmodig	old‐fashioned
gap	abyss
gapa	gape
gapskratta	roar with laughter
garantera	guarantee
garde	guard
garderob	cloakroom
garn	thread
garnison	garrison
gas	gas
gasell	gazelle
gast	ghost
gastrampa	accelerator
gata	street
ge	give
gebit	region
gedigen	pure
gemak	chamber
gemen	accustomed
gemenligen	ordinarily
gemensam	common
gemenskap	community
gen	short
general	general
genever	gin
genklang	echo
genljud	echo
genljuda	echo
genmäle	answer
genom	through
genomtrött	exhausted
gensvarig	rude
geografi	geography
geologisk	geological
geometri	geometry
germansk	Germanic
gest	gesture
gestalt	figure
get	she‐goat
geting	wasp
gevär	gun
ge sig iväg	absent onself
gid	handbook
gift	married
gifta sig	marry
gifta sig med	become the wife of
giftig	poisonous
gift par	couple
gikt	arthritis
ginst	greenweed
giraff	giraffe
girig	avaricious
girland	garland
gissa	guess
gisslan	hostage
gitarr	guitar
gitta	be able to
giva	give
givande	fertile
given	certain
givmild	generous
gjuta	pour
glad	cheerful
gladlynt	cheerful
glansslipa	polish
glas	glass
glass	ice
glasyr	glaze
glasögon	glasses
glatt	smooth
gles	airy
glida	glide
glob	ball
glugg	hole
glöd	glow
glöda	glow
glömma	forget
glömsk	forgetful
glåmig	pale
gnaga	gnaw
gnida	rub
gnidare	miser
gnista	spark
gno	rub
gnugga	rub
gnägga	neigh
god	good
goddag	good afternoon
godhet	goodness
godhjärtad	good‐hearted
godkänna	approve
godkännande	acclaim
godmodig	good‐hearted
godvillig	voluntary
god afton	good evening
god kväll	good evening
god morgon	good morning
golv	floor
gosse	boy
grad	degree
graf	grave
gram	gram
grammatik	grammar
grammatika	grammar
gran	fir
granat	grenade
granit	granite
granne	neighbour
gratis	free
gratulera	congratulate
grav	pole
gravitation	mortgage
grek	Greek
grekinna	Greek woman
grekisk	Greek
gren	bough
grep	fork
greve	count
grina	cry
gris	hog
gro	accrue
groda	frog
grotta	cave
grubbla	puzzle over
grund	bottom
grunda	erect
grupp	group
gruva	mine
gruvarbetare	miner
gruvlig	agonizing
grym	cruel
gräl	quarrel
gräla	quarrel
grämelse	sadness
gränd	alley
gräns	boundary
gränslös	absolute
gräs	grass
gräshoppa	grasshopper
gräslig	abysmal
gräslök	chive
gräsmatta	lawn
gräva	dig
grävling	badger
grävsvin	badger
gröda	harvest
grön	green
grönsaker	vegetable
grå	grey
gråsparv	sparrow
gråta	cry
gud	god
gudlig	pious
gudomlig	divine
gudsförmädelse	blasphemy
gudsförnekare	atheist
gul	yellow
guld	gold
guldfisk	goldfish
guldgruva	gold‐mine
guldsmed	goldsmith
gummi	rubber
gumse	ram
gunst	favor
gunstig	advantageous
gurka	gherkin
gutår	cheers
gymnasium	high school
gymnastik	gymnastics
gynna	advance
gynnsam	advantageous
gyttja	mud
gädda	pike
gäl	gill
gälla	be worth
gärd	proof
gärna	voluntary
gärning	achievement
gäspa	gape
gäst	guest
gästfri	hospitable
gästgivargård	hostel
gästvänlig	hospitable
gästvänskap	hospitality
gök	cuckoo
gömma	conceal
göra	achieve
göra bekantskap med	make ... acquaintance
göra besviken	disappoint
göra konkurs	be bankrupt
gördel	belt
görlig	achievable
gå	go
gång	occasion
gångbana	pavement
gångbar	passable
gångjärn	hinge
gård	estate
gårdstomt	court
gås	goose
gåta	enigma
gåva	gift
ha	have
hackspett	woodpecker
hagel	hail
haj	shark
haka	chin
hake	hook
hal	slippery
hala	fetch
halkig	slippery
hall	hall
hallon	raspberry
halm	straw
hals	neck
halsband	necklace
halstra	roast
halta	limp
halv	half
halvdager	dusk
halvklot	hemisphere
halvö	peninsula
hammare	hammer
hamn	harbor
hampa	hemp
hamra	hammer
han	he
hand	hand
handel	business
handelsbod	boutique
handelsman	merchant
handla	do business
handled	wrist
handling	achievement
handlov	wrist
handlove	wrist
handske	glove
handväska	hand‐bag
hans	his
hare	hare
harem	harem
harm	offence
harmas	be indignant
harmlig	indignant
harmoni	harmony
harmoniera	accord
harmonika	harmonica
harpa	harp
hart	quite
harva	harrow
hassel	hazel
hasselnöt	hazelnut
hast	haste
hastig	hurried
hastighet	speed
hastighetsgräns	speed‐limit
hat	hate
hata	hate
hatt	hat
hav	sea
hava	have
havande	pregnant
haveri	damage
havre	oats
ha ett förhållande med	associate with
ha fest	celebrate
ha födelsedag	celebrating one's birthday
ha förtroende för	have faith
ha medlidande	have compassion on
ha medlidande med	have compassion on
ha otur	have bad luck
ha respekt för	respect
ha tur	be lucky
hed	heath
heder	honor
hederlig	honorary
hedning	pagan
hednisk	pagan
hedra	honor
hej	hello
hejdlös	absolute
hejsan	hello
hej då	adieu
hej så länge	bye
hektoliter	hectolitre
hel	entire
hela	cure
helgedom	sanctuary
helgon	saint
helig	holy
hellre	preferably
helvete	hell
hem	home
hemgift	dowry
hemland	fatherland
hemlig	secret
hemma	at home
hemsk	alarmed
hemtrevlig	homy
hemåt	home
hennes	her
herr	Mister
herre	gentleman
herrskap	ladies and gentlemen
hertig	duke
hertigdöme	duchy
hertiginna	duchess
hes	hoarse
het	hot
heta	call
hetta	heat
hicka	hiccup
himlakropp	heavenly body
himmel	heaven
himmelsk	celestial
hind	doe
hinder	obstacle
hindra	bar
hingst	stallion
hink	bucket
hisklig	agonizing
hiss	elevator
hissa	lever
historia	story
historiett	anecdote
hit	here
hitta	find
hjort	deer
hjul	wheel
hjulaxel	axis
hjälm	helmet
hjälp	aid
hjälpa	accomodate
hjälpare	aid
hjälplös	helpless
hjälte	hero
hjältemodig	heroic
hjältinna	heroine
hjärna	brain
hjärta	heart
hjärtlig	hearty
hjässa	skull
hojta	cry out
holländare	Dutchman
holländsk	Dutch
hon	her
honnör	honor
honorar	fee
honung	honey
hop	accumulation
hopp	hope
hoppa	jump
hoppas	hope
hopplös	abysmal
hora	hooker
horisont	horizon
horisontal	horizontal
horn	horn
hos	at
hospital	insane asylum
hosta	cough
hot	menace
hota	menace
hotell	hotel
hotelse	menace
hov	hoof
hovjärn	horseshoe
hud	skin
hugg	blow
hugga	chop
huggorm	adder
hugskott	caprice
humla	bumblebee
hummer	lobster
humor	humor
humoristisk	humourous
humör	humour
hund	dog
hundra	hundred
hunger	hunger
hungersnöd	famine
hungra	be hungry
hungrig	hungry
hurra	hurray
hus	house
husdjur	domestic animal
husnummer	number
husockupant	squatter
hustru	wife
husägare	house‐owner
huv	cap
huvud	head
huvudgärd	pillow
huvudled	major road
huvudskål	skull
huvudstad	capital
huvudvärk	headache
hvit	white
hydda	cabin
hyena	hyaena
hyende	cushion
hygien	hygiene
hygienisk	hygienic
hymn	anthem
hypnos	hypnosis
hypnotisera	hypnotize
hypnotisör	hypnotist
hypotek	mortgage
hypotes	hypothesis
hypotetisk	hypothetical
hyra	hire
hyra ett rum	live in lodgings
hyrbil	taxi
hyresgäst	renter
hyreskontrakt	lease
hysa	conceal
hysteri	hysteria
hysterisk	hysterical
hytt	cabin
hyvel	plane
hyvla	abrade
häck	hedge
häcka	incubate
häda	slander
hädare	blasphemer
hädelse	blasphemy
häger	heron
hägna	fence off
häkta	clasp
häkte	apprehension
häl	heel
hälft	half
häll	tile
hälla	pour
hälsa	greet
hälsning	greeting
hämna	avenge
hämnd	revenge
hända	come about
händelse	chance
händelsevis	by accident
hänförelse	alacrity
hänga	droop
hänga upp	hang
hängsle	hinge
hänsyftning	allusion
häntydning	allusion
här	army
härska	control
härskare	ruler
härstamma	accrue
häst	horse
hästkraft	horsepower
hästsko	horseshoe
hävda	assert
hävdvunnen	traditional
häxa	witch
häxeri	sorcery
hö	hay
höft	thigh
höghus	apartment building
högvatten	high tide
höjd	height
hök	hawk
hölja	cover
höna	chicken
höns	chicken
höra	hear
hörare	listener
hörsam	obedient
hörsamma	obey
höst	autumn
hösta	harvest
hövlig	courteous
håg	tendency
hågkomst	recollection
hål	hole
hålla	hang onto
hållning	attitude
hån	mockery
håna	jeer at
hår	hair
hård	hard
hårfrisör	barber
hårfrisörska	hairdresser
i	a
ibland	among
icke	not
ideal	ideal
idel	pure
identisk	identical
idiot	idiot
idissla	chew the cud
idol	idol
idrott	sport
idé	idea
ifrån	from
ifylla	fill
igenom	through
igår	yesterday
ihop	together
ihågkomma	recall
illa	bad
illasinnad	adverse
illgärning	crime
illmarig	clever
illusion	illusion
illustrera	illustrate
ilsken	angry
imitera	imitate
imma	steam
in	inwards
inbjuda	invite
inbjudan	invitation
inbjudning	invitation
inbrottstjuv	burglar
inbyggare	inhabitant
indian	Indian
indisk	Indian
individ	individual
individuell	individual
industri	industry
industriell	industrial
inemot	across from
infall	on the occasion of
infanteri	infantry
infektion	infection
infödd	aboriginal
ingalunda	by no means
ingefära	ginger
ingen	neither
ingenjör	engineer
ingenstans	nowhere
ingenstädes	nowhere
ingenting	nothing
inhemsk	aboriginal
initialbokstav	initial
inne	at home
innehava	own
innehåll	contents
inpå	until
inreda	arrange
inredning	accommodation
inregistrera	record
insekt	bug
insjukna	be taken ill
insjö	lake
inspektera	inspect
inspektion	inspection
inspektor	inspector
instifta	erect
instinkt	instinct
instruktion	directions
instrument	agent
inställa	install
inteckning	mortgage
internationell	international
intervall	interval
intervjua	interview
intet	nothing
inte alls	not at all
intill	until
intim	close
intolerant	intolerant
intressant	interesting
intresse	interest
intrig	plot
inträde	entrance
inträdesbiljett	admission ticket
inträffa	come about
invalid	disabled
invandra	immigrate
invit	invitation
invitera	invite
invånare	inhabitant
inälvor	intestines
inöva	exercise
inåt	inwards
irländare	Irishman
irländsk	Irish
irra	roam
is	ice
isberg	iceberg
isländsk	Icelandic
islänning	Icelander
italienare	Italian
italiensk	Italian
i afse	last night
i afton	this evening
i allmänhet	generally
i går	last night
i sänder	at the same time
ja	yes
jacka	jacket
jaga	chase
jaka	affirm
jakt	yacht
jalu	envious
jalusi	envy
januari	January
japanes	Japanese
japanesisk	Japanese
japansk	Japanese
jarl	nobleman
javan	Javanese
javanes	Javanese
javanesisk	Javan
javansk	Javan
jord	ground
jordbeck	asphalt
jordbruk	agriculture
jordbrukare	agrarian
jordbävning	earthquake
jordfästa	bury
jordglob	globe
jordgubbe	strawberry
jordklot	globe
journal	daily paper
journalist	journalist
ju	certainly
jude	Hebrew
judisk	Hebrew
jul	Christmas
juli	July
jungfru	virgin
jungfrulig	virgin
juni	June
just	just
juvel	gem
juvelerare	jeweller
juver	udder
jägare	hunter
jämföra	compare
jämförelse	comparison
jämlik	equal
jämlikt	according as
jämn	even
jämna	even
jämvikt	equilibrium
jänta	girl
järn‐	iron
järn	iron
järnväg	railroad
järnvägståg	train
järv	wolverine
jäst	yeast
jätte	giant
jättelik	gigantic
kabel	cable
kabeljo	cod
kabinett	cabinet
kadaver	cadaver
kaffe	coffee
kafé	café
kaj	platform
kajuta	cabin
kaka	cake
kakao	cocoa
kakel	tile
kaktus	cactus
kalas	celebration
kalasa	celebrate
kalender	calendar
kalk	lime
kalkon	turkey
kall	bleak
kalla	call
kallas	be called
kalv	calf
kamel	camel
kamfer	camphor
kamin	furnace
kamma	comb
kammare	chamber
kamp	action
kampingplats	camping ground
kamrat	buddy
kanadensare	Canadian
kanal	canal
kanapé	couch
kanariefågel	canary
kanhände	maybe
kanin	rabbit
kanna	jug
kannibal	cannibal
kanon	cannon
kanot	canoe
kanske	maybe
kant	side
kaos	chaos
kap	cape
kapital	capital
kapitel	chapter
kappa	cloak
kapprum	cloakroom
kappsäck	trunk
kapris	caprice
kapsyl	capsule
kapten	captain
kaputt	broken
kar	tub
karaff	carafe
karaffin	carafe
karakterisera	characterize
karakterisk	characteristic
karaktär	character
karavan	caravan
karburator	carburettor
karl	fellow
karneval	carnival
karp	carp
karriär	career
kart	unripe fruit
karta	card
kartong	cardboard
kasematt	bunker
kasern	barracks
kasino	casino
kaskad	waterfall
kasko	hull
kassa	cashier's stand
kassör	cashier
kasta	throw
kastanje	chestnut
katalog	catalogue
katarr	catarrh
katastrof	catastrophe
kateder	pulpit
katedral	cathedral
kategori	category
katolik	Catholic
katolsk präst	pastor
katt	cat
kautschuk	rubber
kavalleri	cavalry
kaviar	caviar
kedja	chain
kejsardöme	empire
kejsare	emperor
kejsarinna	empress
kela	coddle
kemi	chemistry
kila	run
kilogram	kilo
kilometer	kilometre
kina	cinema
kind	cheek
kines	Chinaman
kinesisk	Chinese
kirurg	surgeon
kirurgisk	surgical
kisel	flint
kista	box
kitt	cement
kiv	quarrel
kjol	skirt
kjortel	skirt
klaga	complain
klagande	accuser
klagomål	accusal
klar	clear
klass	class
klassisk	classic
klav	clef
klen	faint
klentrogen	skeptical
klia	itch
klibba	stick
klicka	abort
klientel	clientèle
klimat	climate
klinga	blade
klinik	clinic
klint	cornflower
klippa	rock
klipsk	clever
kliva	climb
klo	claw
kloak	sewer
klocka	watch
klockarmband	watch
klok	sagacious
klokhet	wisdom
klor	chlorine
klosett	toilet
kloster	monastery
klot	ball
klubb	club
klyftig	clever
klyva	split
klädedräkt	costume
kläder	clothes
klädsel	clothes
klädskåp	clothes‐press
klänning	dress
klättra	climb
klösa	scratch
klöv	hoof
klöver	clover
klå	scratch
klåda	itch
knacka	hit
knaka	crack
knapp	button
knappast	barely
knappnål	pin
knappt	barely
knekt	pawn
knep	subterfuge
knepig	clever
knip	stomach ache
knippa	bunch
knipslug	clever
kniv	knife
knopp	bud
knusslare	miser
knut	knot
knyte	bunch
knä	knee
knäbyxor	short pants
knäck	push
knäcka	break
knåda	knead
ko	cow
kock	cook
kod	code
koffert	trunk
koja	cabin
koka	boil
kokare	kettle
kokerska	cook
kokosnöt	coconut
kol	coal
kollega	colleague
kollegium	college
koloni	colony
kolossal	colossal
koltrast	blackbird
komedi	comedy
komet	comet
komisk	comic
komma	comma
kommande	next
kommando	command
kommendant	commander
kommendera	command
kommissarie	chief of police
kommission	commission
kommitté	committee
kommun	community
kommunikationstabell	schedule
kommunism	communism
kompass	compass
kompetent	able
kompis	friend
komplett	absolute
komplimang	compliment
komplott	conspiracy
komponera	compose
kompositör	composer
koncept	concept
kondition	condition
konditor	confectioner
konditori	confectionery
kondom	condom
konduktör	guard
konfession	acknowledgement
konfiskera	confiscate
konflikt	conflict
konfys	jumbled up
kongress	congress
konjak	brandy
konklusion	conclusion
konkret	concrete
konkurrens	competition
konkurs	bankruptcy
konsert	concert
konservativ	conservative
konservera	conserve
konsonant	consonant
konst	art
konstalster	work of art
konstant	constant
konstapel	policeman
konstföremål	work of art
konstgjord	artificial
konstgrepp	subterfuge
konstnär	artist
konsul	consul
konsulat	consulate
konsultera	consult
kontakt	contact
konto	account
kontor	office
kontrakt	contract
kontramärke	acknowledgement
kontrast	contrast
kontrollant	checker
kontrollera	audit
kontrollör	checker
konung	king
konungarike	kingdom
konungslig	regal
konvalje	lily‐of‐the‐valley
konversation	conversation
kopia	copy
kopiera	copy
kopp	cup
koppar	copper
koppor	smallpox
kor	chorus
kora	choose
korespondera	correspond
korg	basket
kork	cork
korkskruv	corkscrew
korn	grain
korrekt	correct
korrigera	correct
kors	cross
korsord	crossword puzzle
korstfästa	crucify
kort	card
kortsynt	near‐sighted
korv	sausage
kosa	direction
kosta	cost
kostbar	dear
kostnadsfri	free
kostym	costume
kotlett	cutlet
krabba	crab
krafsa	scratch
kraft	force
kraftfull	strong
kraftig	strong
krage	collar
kram	barn
krama	embrace
krambod	bazaar
kran	crane
krasch	ado
krasse	nasturtium
kratta	rake
kredit	credit
krets	district
krig	war
kriga	make war
krigare	warrior
krigisk	martial
kriminal	criminal
kring	about
kringgå	avoid
kris	crisis
kristall	crystal
kristen	Christian
kristendom	Christianity
kristlig	Christian
kristna	baptize
kristning	baptism
krita	chalk
kritik	criticism
krok	bend
krokig	bent
krokodil	crocodile
krom	chromium
kronärtskocka'ärtskocka	artichoke
kropp	body
kroppslig	bodily
krossa	crush
kruka	jug
krumbukt	bend
krusbär	gooseberry
krut	gunpowder
kry	cheerful
kryp	bug
krypa	crawl
kräfta	cancer
kräkas	throw up
kräla	crawl
kräldjur	reptile
kräm	cream
krönika	chronicle
kröning	coronation
kråka	crow
kub	cube
kudde	cushion
kula	bullet
kulle	hill
kultur	culture
kund	client
kung	king
kungarike	kingdom
kunskap	acquaintance
kunskapare	spy
kupong	coupon
kupé	compartment
kurry	curry
kurs	class
kurva	bend
kusin	cousin
kust	coast
kvadrat	square
kvadratmeter	square metre
kvalitet	property
kvart	quarter of an hour
kvarter	district
kvast	broom
kvicksilver	mercury
kvinna	woman
kvinnlig	female
kvist	bough
kvitto	acknowledgement
kväll	evening
kväve	nitrogen
kyckling	chick
kyffe	den
kypare	waiter
kyrka	church
kyrkogård	cemetery
kyrkoherde	pastor
kysk	chaste
kyss	kiss
kyssa	kiss
käft	jaws
källare	basement
kämpa	fight
känd	well‐known
känguru	kangaroo
känna	be acquainted with
kännedom	acquaintance
känsla	emotion
kär	dear
kärlek	affection
kärna	core
kärr	marsh
kärv	acerbic
kättare	heretic
kätteri	heresy
kö	file
kök	kitchen
köksa	cook
köl	keel
köld	cold
kön	sex
köpare	buyer
köpesumma	purchase money
köping	town
körkort	driving‐licence
körsbär	cherry
kött	flesh
kål	cabbage
laboratorium	laboratory
lada	depository
ladda	burden
lag	law
lam	lame
lamm	lamb
lampa	lamp
land	country
landkarta	map
landsbo	countryman
landsbygd	country
landskap	landscape
landsmål	dialect
landsort	country
lans	lance
lantbruk	agriculture
lantbrukare	agrarian
lapp	Laplander
lappländsk	Lapp
lapsk	Lapp
larm	alarm
larma	make a noise
larv	grub
lasta	burden
lastbil	lorry
lat	lazy
latinläroverk	high school
lav	moss
lava	lava
lavin	avalanche
lax	salmon
laxativ	laxative
le	smile
ledsen	dismal
leende	smile
lega	hire
legation	legation
legend	legend
legering	alloy
legitimera	legitimize
leja	hire
lejon	lion
lek	game
leka	play
lekamen	body
lekamlig	bodily
lekman	layman
leksak	toy
lekskola	nursery school
lektion	lesson
lektor	instructor
lektyr	reading matter
lem	limb
len	soft
lena	soften up
ler	clay
lera	clay
leta	look for
leva	be alive
levande	alive
lever	liver
leverans	delivery
leverera	deliver
leverkorv	liver sausage
levnad	life
liberal	liberal
lida	abide
lie	scythe
ligga	lie
lik	equal
likafullt	but
lika ... som	as ... as
likfärd	mourning
likgiltig	immaterial
likhet	resemblance
likkista	coffin
likna	compare
liknande	like
liknelse	comparison
liknöjd	immaterial
liktorn	corn
likvid	payment
likör	liqueur
lilja	lily
liljekonvalje	lily‐of‐the‐valley
lim	glue
limma	glue
limonad	lemonade
lin	flax
lina	cord
lind	lime‐tree
linjal	ruler
linje	line
lins	lens
lisma	flatter
lita på	rely on
lite	a little
liten	tiny
liter	liter
litet	a little
litteratur	literature
liv	life
livaktig	adroit
livbåt	life‐boat
livlig	adroit
livmoder	uterus
livräddningsbåt	life‐boat
ljud	sound
ljuda	sound
ljudelig	loud
ljudlig	loud
ljuga	lie
ljum	lukewarm
ljus	blond
lo	lynx
lockande	attractive
lodjur	lynx
loft	attic
logik	logic
lojal	faithful
lok	engine
lokal	local
lokomotiv	engine
longitud	longitude
loppa	flea
lotsa	pilot
lotteri	lottery
lova	commend
lovsång	anthem
luft	air
luftkrets	atmosphere
lunga	lung
lupin	lupine
lura	cheat
lus	louse
lutter	clean
luttra	clean
lyceum	lyceum
lycka	happiness
lycklig	fortunate
lyda	obey
lydig	obedient
lyssna	listen
lyte	absence
lyx	luxury
läcker	nice
läder	leather
läderlapp	bat
lägenhet	apartment
läger	camping ground
lägga	lay
läkare	doctor
läkemedel	drug
lämna	abandon
län	fief
längd	length
länge	a long time
längtan	desire
längta efter	ache
läpp	lip
lära	learn
lärare	instructor
lärarinna	teacher
lärka	lark
lärkträd	larch
läsa	read
läskpapper	blotter
läslig	legible
lätt	easy
lätta	facilitate
lättad	relieved
lättnad	relief
läxa	lesson
lödder	foam
löfte	affirmation
lögn	lie
löjlig	ridiculous
löjtnant	lieutenant
lök	onion
lön	salary
löngivare	employer
lönn	maple
lönnlig	secret
löntagare	employee
löpa	march
lördag	Saturday
löv	foliage
låda	drawer
låg	low
låga	flame
låna	borrow
låna av	lend
lång	long
långfredag	Good Friday
långsam	slow
lår	box
lås	lock
låsa	lock
låt	melody
låta	sound
låtsas som om	feign
madrass	mattress
magasin	warehouse
mage	stomach
magisk	magical
magknip	stomach ache
magnet	magnet
magnetisk	magnetic
maj	May
majbagge	june bug
major	major
majs	corn
maka	wife
make	husband
makrill	mackerel
makt	ability
malajisk	Malay
malm	ore
malt	malt
mamma	mam
man	husband
mandarin	tangerine
mandel	almond
mandom	courage
mandråp	murder
maner	manner
manet	jelly‐fish
mangrant	all
maning	admonition
manlig	male
manöver	maneuver
mara	nightmare
margarin	margarine
marin	navy
mark	territory
marknad	market
marmelad	jam
marmor	marble
mars	March
marschall	torch
marter	torture
martera	agonize
martyr	martyr
mask	mask
maskin	engine
massiv	massive
mast	mast
mat	food
matematik	mathematics
materia	matter
material	data
materiell	material
matlust	appetite
maträtt	food
matsedel	menu
maxiumum	maximum
med	with
medalj	medal
medborgare	citizen
medbringa	bring along
meddela	advertise
meddelande	ad
medeltal	average
medeltida	Middle Ages
medge	admit
medicin	drug
medlidande	compassion
medljud	consonant
medverka	cooperate
medvetande	awareness
medvetslös	unconscious
meja	cut
mejsel	chisel
mellan	among
melodi	melody
melon	melon
men	but
mena	mean
mening	sentence
menlig	adverse
mer	more
mera	more
merendels	ordinarily
mes	titmouse
mest	most
metall	metal
meter	metre
metkrok	hook
metod	method
metspö	fishing rod
mexikan	Mexican
mickel	fox
mikroskop	microscope
mil	mile
mild	gentle
militär	warrior
miljon	million
million	million
min	my
mina	mine
minderårig	under age
mindretal	minority
mineral	mineral
minesslö	forgetful
minister	minister
ministär	ministry
minnas	recall
minne	memory
minnesmärke	monument
minnesvård	monument
minut	minute
missa	miss
missakta	despise
missbelåten	discontented
missbilliga	condemn
missbruk	abuse
missdåd	crime
missförhållande	abuse
missförstånd	misunderstanding
misskund	compassion
missnöjd	discontented
missräkning	disappointment
misstag	aberration
misstanke	suspicion
misstro	distrust
misstroende	suspicion
misstrogen	suspicious
misströsta	despair
misströstan	despair
mist	fog
mista	lose
mistaga sig	err
mista sig	err
mitt	my
mjuk	soft
mjäll	dandruff
mjöl	flour
mjölk	milk
mjölka	milk
mjölnare	miller
mod	mood
modell	model
moder	mother
modern	modern
mogen	mature
mogna	ripen
mohammedan	Mohammedan
molekyl	molecule
moln	cloud
momang	instant
moment	instant
monopol	monopoly
monster	monster
montera	assemble
monument	monument
moped	moped
mor	mother
moras	marsh
morbroder	uncle
morbror	uncle
mord	murder
morfar	maternal grandfather
morfin	morphia
morföräldrar	grandparents
morgift	antidote
morgon	morning
mormoder	grandfather
mormon	Mormon
mormor	grandmother
morot	carrot
moské	mosque
mossa	moss
moster	aunt
mot	across from
motgift	antidote
motiv	account
motor	engine
motorcykel	motorcycle
motsats	antithesis
motsatt	adverse
mudder	mud
mula	mule
mullvad	mole
multiplicera	multiply
mulåsna	hinny
mumie	mummy
mun	mouth
munk	monk
mur	wall
mura	build
murare	mason
murgröna	ivy
mus	mouse
musa	muse
museum	museum
musik	music
musikalisk	musical
musikant	musician
musiker	musician
muskel	muscle
mussla	mussel
mustasch	moustache
mycket	quite
mygga	gnat
myndig	adult
mynt	coin
mynta	mint
myra	ant
mysa	smile
mysterium	mystery
mysteriös	abstruse
mystisk	mystic
myt	myth
mäklare	broker
mäkta	be able to
mäktig	powerful
mängd	accumulation
människa	man
mänsklig	human
mänsklighet	human race
märka	notice
märklig	noteworthy
märkvärdig	noteworthy
mässing	brass
mässling	measles
mästare	boss
mästarinna	mistress
mästerman	hangman
mätt	full
mätta	be full
mö	girl
möbel	piece of furniture
möblemang	furniture
möblera	furnish
möblerad	furnished
möda	effort
mödosam	difficult
mögel	mold
mögla	get mouldy
möjlig	possible
mönster	sample
mör	soft
mörda	murder
mördare	murderer
mörker	darkness
mössa	cap
möta	come across
mötas	meet
möte	meeting
må	have to
måg	son‐in‐law
måhände	maybe
måla	paint
målare	painter
målning	painting
måltid	meal
månad	month
måndag	Monday
måne	moon
många	many
mård	marten
mås	seagull
måse	seagull
måste	have to
nackdel	disadvantage
nacke	back of the neck
nafta	crude oil
nagel	nail
nagelborste	nail‐brush
naiv	naïf
naken	bare
nalkas	advance
namn	appellation
namnteckning	signature
nappa	bite
nappflaska	baby's bottle
narciss	daffodil
narr	fool
narra	cheat
narri	gag
nation	nation
nationalitet	nationality
nationell	national
natt	night
nattfjäril	moth
natur	nature
naturgas	natural gas
naturlig	natural
nazist	Nazi
ned	down
nedan	below
nederlag	defeat
nederländare	Dutchman
nederländsk	Dutch
nedrig	abject
nedsmutsa	soil
nedstämd	depressed
nedsvärta	slander
nedvänd	down
negativ	negative
neger	Negro
nej	no
nejlika	carnation
neka	deny
ner	down
nere	below
nerv	nerve
nervös	agitated
nesa	shame
neutral	impartial
nickel	nickel
niding	cheat
nie	nine
nio	nine
nionde	ninth
nisch	niche
nitti	ninety
nittio	ninety
nitton	nineteen
nittonde	nineteenth
nivå	level
njugg	avaricious
njure	kidney
njuta	be glad
noga	accurate
noll	nought
nolla	naught
nord	north
nordisk	Scandinavian
nordlig	northern
normal	normal
norr	northern
norra	northern
norra om	above
norrman	Norwegian
norrut	north
norr om	above
norsk	Norwegian
noshörning	rhino
nota	account
notera	note
notisbok	notebook
novell	short story
november	November
nu	at present
nummer	number
nummerplåt	numberplate
nunna	nun
nutida	currently
nuvarande	currently
ny	new
nybörjare	beginner
nyck	caprice
nyckel	key
nyfiken	agog
nymf	nymph
nysa	sneeze
nyss	just
nyttig	advantageous
nyttja	make use of
nyår	New Year
näbb	beak
näckros	waterlily
näktergal	nightingale
nämligen	namely
näppeligen	barely
näpsa	punish
när	when
närhet	nearness
närmaste	next of kin
närsynt	near‐sighted
närvarande	present
närvaro	presence
näsa	nose
näsborr	nostril
nässla	nettle
nästan	almost
näste	den
nät	net
näve	fist
nöjd	contented
nöt	bovine
nötkött	beef
nå	now
nåd	favor
någon	a
någonsin	at some time
någonstans	anywhere
någonstädes	anywhere
någonting	anything
någorlunda	a little
något	anything
nål	needle
nåväl	now
o‐	dis‐
oaktat	but
oaktsam	careless
oangenäm	bleak
oartig	rude
oas	oasis
oavhängig	independant
oavlåtlig	all the time
oavsiktlig	unintentional
obegriplig	inconceivable
obegränsad	absolute
obehaglig	bleak
obekant	unknown
oberoende	independant
objekt	article
oblandad	pure
oblyg	rude
observera	keep
obskur	obscure
ocean	ocean
och	and
också	also
ockupera	overpower
odjur	monster
odräglig	unbearable
oenig	at variance
oenighet	disagreement
oense	at variance
ofall	accident
ofattlig	inconceivable
offensiv	aggressive
offentlig	public
offentliggöra	publish
offert	offer
officer	officer
officiell	official
ofruktbar	barren
ofta	frequently
ofördelaktig	adverse
ofördragsam	intolerant
oförhoppandes	abrupt
oförklarlig	inexplicable
oförmedlad	abrupt
oförmodad	abrupt
oförsynt	rude
ogift	single
ogärning	crime
ogärningsman	criminal
ohederlig	nasty
ohyra	vermin
ohövlig	rude
oklar	indistinct
okokt	raw
oktober	October
oktroj	patent
okysk	lewd
okänd	unknown
olik	different
olika	different
olikhet	difference
oliv	olive
olja	oil
oljud	ado
ollon	acorn
olycklig	unhappy
olycksfall	accident
olydig	disobedient
olåt	ado
om	about
omak	effort
omdöme	judgment
omelett	omelette
omfamna	embrace
omfång	bulk
omfångsrik	ample
omgiva	surround
omnibus	omnibus
omogen	unripe
område	region
omtanke	care
omyndig	under age
omättlig	insatiable
omöjlig	impossible
om aftarna	in the evening
om morgonen	in the morning
om natten	at night
om än	though
onaturlig	artificial
ond	bad
onsdag	Wednesday
oordning	chaos
opal	opal
opartisk	impartial
opera	opera
operation	operation
operera	operate
optiker	optician
optimism	optimism
opålitlig	unreliable
orakel	oracle
orange	orange
ord	word
orda om	discuss
ordbok	dictionary
orden	order
order	command
ordinär	accustomed
ordspråk	adage
oredig	dazed
oregelbunden	abnormal
orena	soil
organ	organ
organisation	organization
orgel	organ
orient	east
orientalisk	eastern
original	aboriginal
oriktig	incorrect
ork	energy
orka	be able to
orkan	hurricane
orkester	orchestra
orm	serpent
orsak	cause
orsaka	activate
ort	place
ortlig	local
orätt	incorrect
osa	reek
osann	false
osedlig	lewd
oskuld	innocence
oskyldig	guiltless
oss	us
ost	cheese
ostlig	eastern
ostron	Austrian
ostyrig	savage
osympatisk	nasty
otacksam	thankless
otalig	countless
otrevlig	bleak
otro	suspicion
otrogen	suspicious
otrolig	incredible
otur	bad luck
otålig	impatient
oupphörlig	constant
ouppmärksam	careless
oval	oval
ovan	unusual
ovass	blunt
oviktig	unimportant
oviss	uncertain
oväder	foul weather
oväldig	impartial
ovän	adversary
ovänlig	brutal
oväntad	abrupt
oväsen	ado
oxe	ox
oändlig	absolute
oärlig	nasty
oövervinnelig	invincible
packa	pack
packe	bunch
padda	toad
paket	packet
palats	palace
paletå	coat
palm	palm
pamflett	pamphlet
panik	panic
panna	forehead
pantomim	pantomime
papegoja	parrot
par	pair
para	associate
parad	display
paradis	paradise
paraffin	paraffin
paragraf	paragraph
parallel	parallel
paraply	umbrella
parasit	parasite
parfym	perfume
parisare	Parisian
park	park
parlament	parliament
part	faction
parti	faction
partigängare	member
partisk	biased
partvalv	porch
pass	passport
passagerare	passenger
passera	come about
passion	lust
passionerad	passionate
pastor	pastor
patent	patent
pater	monk
patient	patient
patriark	patriarch
patrull	patrol
paus	break
paviljong	pavilion
pedal	pedal
pelare	column
pelikan	pelican
pengar	money
penna	feather
pension	pension
peppar	pepper
pepparrot	horse‐radish
per	by
periferi	outskirts
period	period
perrong	platform
perser	Persian
persika	peach
persilja	parsley
person	person
personlig	personal
personnummer	personal number
peruk	hairpiece
pessimistisk	pessimistic
pest	pestilence
petroleum	paraffin‐oil
piano	piano
piggsvin	porcupine
pil	arrow
pilgrim	pilgrimage
piller	pill
pilt	boy
pina	ache
pingst	Pentecost
pinie	pine
pinje	pine
pinsam	painful
pion	pawn
pionjär	pioneer
pionär	pioneer
pipa	pipe
pirat	pirate
pistol	pistol
planet	planet
plank	board
plant	plant
plantera	plant
platan	plane
platina	platinum
platta	dial
plikt	fine
plocka	pick
plog	plough
plommen	plum
plym	plume
plöja	plough
plötslig	abrupt
plåga	agonize
poesi	poetry
pojke	boy
pokal	goblet
pol	pole
polack	Pole
polera	polish
polis	police
poliskommissarie	chief of police
poliskonstapel	policeman
polisstation	police‐station
politik	policy
politiker	politician
politisk	political
polsk	Polish
polyp	polyp
poppel	poplar
populär	popular
port	gate
portativ	portable
portfölj	brief case
portion	share
portmonnä	purse
porto	postage
portofri	post‐paid
portugis	Portuguese
portvakt	porter
portvaktare	porter
position	position
post	mail
postbud	postman
postkontor	post office
postnummer	postal code
posttjänsteman	mailman
potatis	potato
praktik	practice
praktisk	practical
prata	chat
praxis	tradition
precis	accurate
predika	preach
predikan	sermon
predikant	preacher
present	gift
president	chairman
preussare	Prussian
preventivmedel	preservative
primitiv	primitive
princip	principle
prins	prince
pris	price
prisa	commend
privilegium	privilege
probera	attempt
problem	problem
procent	percent
process	process
processa	act
procession	procession
producera	afford
produkt	product
profession	profession
professor	professor
profet	prophet
profil	profile
profitera	profit
projekt	plan
proklamation	proclamation
proletär	proletarian
promenad	stroll
promenera	go for a walk
prompt	accurate
propagando	propaganda
prosa	prose
prost	pastor
protest	protest
protestant	Protestant
prov	proof
prova	attempt
provbit	sample
provins	province
provinsiell	provincial
präst	clergyman
prästgård	parish
psalm	psalm
pseudonym	pseudonym
psyke	psyche
psykiater	psychiatrist
psykiatri	psychiatry
psykiatriker	psychiatrist
psykisk	psychic
publicera	publish
publicist	journalist
publik	public
puckel	bump
pudding	pudding
puff	push
puffa	push
puls	pulse
pulsera	pulsate
pulver	powder
pump	pump
pumpa	pump
pund	pound
pur	pure
purpur	purple
puss	kiss
pussa	kiss
puts	gag
pyjamas	pyjamas
pyramid	pyramid
päls	fur
pärla	pearl
päron	pear
på	at
påbjuda	command
påbud	command
påfallande	striking
påfågel	peacock
påle	pole
pålitlig	reliable
påsk	Easter
påstå	assert
påstående	contention
påve	pope
påverka	act
rabbin	rabbi
rabies	rabies
rackare	cheat
rad	file
radhus	terrace house
radio	radio
ragata	shrew
ragu	ragout
rak	direct
raka	run
rakblad	razor‐blade
raket	rocket
rakkniv	razor
ramla	make a noise
rang	grade
rapphöna	partridge
rapport	account
rapportera	give an account
rar	dear
ras	breed
rasande	furious
rasp	file
rast	repose
rasta	repose
reaktion	reaction
reaktionär	reactionary
real	actual
realisera	produce
rebell	rebel
recept	prescription
redaktör	editor
redan	already
redd	anchorage
redlig	above‐board
redo	finished
reell	actual
regel	bolt
regelmässig	even
regemente	regiment
regera	control
regering	administration
regim	régime
regissör	stage‐manager
register	account book
registrera	record
regla	bolt
reglemente	regulations
regn	rain
regna	rain
regnbåge	rainbow
regnrock	raincoat
reklam	ad
rekommendabel	recommendable
rekommendation	recommendation
rekommendera	commend
rekord	record
rekryt	recruit
rektor	rector
relation	relation
religion	religion
religiös	religious
rem	belt
ren	already
rena	clean
rengöra	clean
renlärig	orthodox
renommerad	famous
rensa	clean
renskt vin	hock
rep	cord
reparera	fix
repertoar	repertoire
replik	answer
reproduktion	reproduction
reptil	reptile
republik	republic
resa	journey
resande	traveller
resebyrå	tourist agency
resgods	baggage
respekt	respect
respektera	respect
rest	remainder
restaurang	restaurant
resultat	conclusion
reta sig på	be indignant with
revisor	accountant
revolution	revolution
revolutionär	revolutionary
revolver	revolver
rida	ride
riddare	cavalier
rigel	bolt
rik	affluent
rikedom	abundance
riktig	fair
riktning	direction
rim	rhyme
rimma	rhyme
ring	ring
rinna	flow
ris	twig
risgryn	rice
risk	hazard
riskera	hazard
rita	design
ritning	design
ritual	ritual
riva	rub
rival	rival
ro	repose
roddbåt	row‐boat
roder	rudder
roffa	plunder
roll	part
roman	novel
romare	Roman
romersk	Roman
ropa	call
ros	rose
rost	rust
rosta	roast
rostbiff	roastbeef
rostig	rusty
rot	root
rote	district
rovdjur	beast of prey
rubin	ruby
rubrik	column
ruckel	den
ruelse	repentance
ruin	ruin
ruinera	ruin
rulla	roll
rullgardin	roller‐blind
rumla	drink
rumlare	boozer
rumänsk	Romanian
rund	round
runda	round
rundfråga	inquiry
rusig	drunk
rutin	routine
rutten	addled
ruva	incubate
rycka	jerk
rygg	back
ryggrad	spine
ryggsäck	backpack
ryka	smoke
rykte	rumor
rymdpilot	astronaut
rymlig	extensive
rymma	escape
rysk	Russian
ryss	Russian
rytm	rhythm
räcka	file
rädd	afraid
rädda	keep
räddning	salvage
räddningsbåt	life‐boat
rädisa	radish
rädsla	agony
räfsa	rake
räkna	prawn
rämna	burst
rät	direct
rätt	justice
rätta	fix
rättegång	action
rättslig	legal
räv	fox
rävhona	vixen
röd	red
rödspotta	plaice
rödspätta	plaice
rök	smoke
röka	smoke
rökelse	incense
rökkupé	smokers
rönnbär	mountain‐ash berry
rör	barrel
röra	admixture
röst	voice
rösta	vote
röva	plunder
rövare	robber
rå	yard
råd	advice
råda	advise
rådfråga	consult
rådhus	town‐hall
rådjur	roe
rådman	alderman
råg	rye
råma	howl
råna	rob
rånare	robber
råtta	mouse
råttfälla	mousetrap
sabbat	Sabbath
sadel	saddle
saft	lemonade
saga	fairy tale
sak	affair
sakna	miss
saknad	absence
saknas	be lacking
sakrament	sacrament
salad	lettuce
salamander	salamander
saldo	balance
saliv	saliva
sallat	lettuce
salong	lounge
salt	salty
saltvatten	salt water
samarbeta	cooperate
sambo	co‐occupant
samhälle	society
samklang	harmony
samla	collect
samlare	accumulator
samling	collection
samliv	society
samman	together
sammanblanda	blend
sammankomst	assemblage
sammanlevnad	society
sammanlikning	comparison
sammanträde	assemblage
samt	equally
sand	sand
sandal	sandal
sandbank	bank
sandig	sand
sann	true
sannerligen	absolutely
sanning	truth
sannolik	likely
sardin	sardine
sarkastisk	acid
sats	sentence
sax	scissors
scen	scene
scepter	sceptre
schackbräde	chessboard
schakal	jackal
schal	shawl
schavott	scaffold
schema	model
schweizare	Swiss
schweizisk	Swiss
se	see
sedan	... ago
sedel	bank‐note
sedesam	chaste
sedeslös	lewd
sefyr	zephyr
segel	sail
segla	sail
sekel	centennial
sekretarere	secretary
sekt	sect
sektion	section
sekund	second
selleri	celery
semester	vacation
semitisk	Semitic
semla	roll
sena	muscle
senap	mustard
september	September
serbisk	Serb
serenad	serenade
sergeant	sergeant
serie	series
servett	napkin
sex	sex
sexti	sixty
sextio	sixty
sextionde	sixtieth
sexton	sixteen
sextonde	sixteenth
sexuell	generative
sfär	ball
shoppa	shop
siare	prophet
siberisk	Siberian
sida	side
siden	silk
signa	bless
signal	mark
sikt	sieve
sikta	sift
sil	filter
sila	filter
silhuett	outline
silke	silk
silkesmask	silkworm
sill	herring
silver	silver
simbyxor	swimming trunks
simma	float
simpel	simple
sin	her
sinnesrörelse	emotion
sippa	anemone
sirap	syrup
siska	last
sitt	her
sitta	sit
sittplats	seat
situation	circumstances
sju	seven
sjubb	raccoon
sjuk	ill
sjukhem	hospital
sjukhus	hospital
sjuksköterska	nurse
sjukvårdare	nurse
sjunde	seventh
sjunga	sing
sjunka	sink
sjutti	seventy
sjuttio	seventy
sjutton	seventeen
sjuttonde	seventeenth
själ	mind
själfständig	independant
själsläkekonst	psychiatry
själv	self
självbehärskning	restraint
självförtroende	self‐confidence
självljud	vowel
självmant	voluntary
självständig	independant
självverkande	automatic
sjätte	sixth
sjö	lake
sjömakt	navy
sjöman	sailor
sjörövare	pirate
sjötunga	sole
skalbagge	beetle
skald	poet
skalle	skull
skam	shame
skamlös	abandoned
skandal	commotion
skapa	create
skapelse	creature
skata	magpie
skatt	treasure
sked	spoon
skelett	skeleton
skepp	ship
skeppare	captain
skeppsbåt	life‐boat
skild	divorced
skiljas	get a divorce
skillnad	difference
skilsmässa	divorce
skinka	ham
skinn	skin
skinna	skin
skiva	dial
skjorta	vest
sko	shoe
skoband	shoe‐lace
skog	forest
skoj	gag
skoja	jest
skola	school
skorsten	chimney
skotsk	Scottish
skotte	Scot
skottår	leap‐year
skratt	laughter
skratta	laugh
skred	avalanche
skri	cry
skria	cry out
skrifta sig	confess
skriftermål	confession
skrik	cry
skrika	jay
skriva	write
skrivare	clerk
skrivbok	exercise‐book
skrivbord	desk
skrivmaskin	typewriter
skrock	superstition
skruv	screw
skruva	screw
skruvmejsel	screwdriver
skrymta	dissemble
skryta	boast
skräddare	tailor
skråla	cry out
skugga	shadow
skuld	blame
skuldra	shoulder
skulptör	sculptor
skum	foam
skumrask	dusk
skurk	cheat
skutt	jump
skutta	jump
sky	cloud
skydda	protect
skyddsling	protégée
skyffel	spade
skyla	cover
skyldig	guilty
skylla	accuse
skylt	shield
skymning	dusk
skägg	beard
skälla	bark
skälla ut	abuse
skällsord	invective
skälva	quiver
skämd	addled
skämt	gag
skämta	jest
skänk	gift
skänka	donate
skärpa	acerbity
sköka	hooker
sköldpadda	tortoise
skön	beautiful
skönhet	beauty
skönja	see
skönjbar	visible
skörd	harvest
skörda	harvest
sköta	attend
skåda	see
skådespel	show
skådespelerska	actress
skål	cheers
skåp	cabinet
sladd	cord
slag	action
slagbom	barrier
slagsmål	action
slaktare	butcher
slakteri	butcher's shop
slakthus	abattoir
slaktoffer	victim
slam	mud
slav	slave
slavisk	Slavic
slem	mucus
slentrianmässig	automatic
slipa	sharpen
slira	glide
slopa	break down
slott	castle
slug	clever
slump	accidence
slup	boat
slut	end
sluta	end
släknamn	surname
släkt	relations
släkting	relative
släktskap	affiliation
slätt	plain
slösa	waste
slöseri	waste
slå	beat
slåss	fight
smacka	smack
smak	taste
smaka	taste
smakfull	nice
smaklig	nice
smaklös	tasteless
smal	gaunt
smaragd	emerald
smed	smith
smicker	flattery
smickra	flatter
smida	forge
smidig	flexible
smink	make up
smittrena	disinfect
smuggla	smuggle
smutsa	soil
smutsig	dirty
smycka	adorn
smäcker	slender
smäkta	ache
smälta	melt
smärt	slender
smärta	hurt
smärtsam	painful
smör	butter
smörgås	bread and butter
småle	smile
småleende	smile
snabbskrift	shorthand
snacka	chat
snart	soon
snava	stumble
snickare	carpenter
snickra	build
snigel	snail
sniken	acquisitive
snodd	cord
snok	serpent
snoka	spy
snubbla	stumble
snuva	cold
snyltgäst	parasite
snyltväxt	parasite
snäcka	snail
snäll	affable
snälltåg	fast train
snäsig	brutal
snö	snow
snödroppe	snowdrop
snöping	eunuch
snöra	bind
snöre	cord
snövit	snow white
snål	acquisitive
so	sow
social	social
socialism	socialism
socka	sock
socken	parish
socker	sugar
sockerrör	sugar‐cane
sockersjuka	diabetes
sockerskål	sugar‐bowl
sofa	sofa
sol	sun
sold	salary
soldat	pawn
solig	solair
solist	soloist
solnedgång	sunset
solros	sunflower
solstråle	sunbeam
soluppgång	sunrise
somliga	a few
sommar	summer
son	son
sonat	sonata
sondotter	granddaughter
sonhustru	daughter‐in‐law
sonson	grandson
sopa	sweep
sopkvast	broom
soppa	soup
sorg	care
sorgsen	dismal
sort	kind
sortiment	assortment
sot	soot
sovra	clean
sovrum	bedroom
sovvagn	sleeping‐car
spad	gravy
spade	spade
spalt	column
spanjor	Spaniard
spannmål	grain
spara	save
spark	kick
sparka	kick
sparris	asparagus
sparsam	thrifty
sparv	sparrow
spasm	clamp
spatsera	go for a walk
spatsertur	stroll
spe	mockery
specerihandlare	grocer
speciell	particular
spegel	looking‐glass
speja	spy
spejare	spy
spektakel	show
spel	game
spela	play
spenat	spinach
spene	udder
spik	nail
spika	nail
spindel	axis
spindelväv	spiderweb
spion	spy
spionera	spy
spira	sceptre
spiral	spiral
spiritism	spiritualism
spirituell	lively
spis	furnace
spjut	lance
splittra	splinter
sporadisk	sporadic
sport	sport
sportsman	sportsman
spott	saliva
springa	race
springare	knight
springvatten	fountain
sprit	alcohol
språk	language
språklära	grammar
språksam	talkative
spy	throw up
späck	bacon
spöke	ghost
spörja	ask
spörsmål	question
spårvagn	streetcar
stack	heap
stad	city
stadig	fixed
stadsbud	porter
stadshus	city hall
stadslik	urban
stam	stem
standar	flag
stank	stench
stanna	remain
stare	starling
stark	strong
stat	state
station	stage
statistik	statistics
statsman	politician
statut	by‐laws
staty	statue
stav	baton
stava	spell
stavelse	syllable
steg	pace
stege	ladder
sten‐	metalled
sten	stone
stenhuggare	stone‐cutter
stenig	metalled
stenrik	immensely rich
stepp	moor
steril	sterile
stia	sty
sticka	match
stig	path
stil	style
stinka	reek
stirra	gaze
stjälk	blade
stjärna	star
stjärntydare	astrologer
stjärt	backside
stoisk	stoic
stoj	ado
stol	chair
stolle	lunatic
stollig	crazy
stolt	proud
stolthet	pride
stop	jug
stor	big
storhet	bulk
stork	stork
storlek	bulk
storm	storm
storma	assault
straff	punishment
straffa	punish
straffavgift	fine
strand	beach
streck	ray
strejk	strike
strejka	strike
strid	action
strida	fight
strimla	ray
strimma	ray
strumpa	sock
strumpsocka	sock
strupe	throat
struts	ostrich
strykjärn	iron
strypa	choke
ström	current
ströming	current
strömma	flow
strå	blade
stråla	radiate
stråle	beam
stråt	path
student	academic
studera	study
studie	study
studium	study
studsa	rebound
stum	dumb
stygg	bad
styre	handlebars
styrka	force
styv	rigid
städerska	maid
städhjälp	maid
ställa	lay down
ständigt	always
stänga	open
stängd	open
stöd	prop
stödja	lean
stöld	abstraction
stöna	groan
stöpa	pour
stör	pole
stöt	push
stöta	push
stövel	boot
stål	steel
stång	baton
subjekt	subject
subsidier	subsidy
substantiv	noun
subtil	subtle
sucka	sigh
suga	suck
suggestion	the power of suggestion
summa	amount
sump	marsh
sund	strait
sundhet	health
supa	drink
supare	boozer
sur	dismal
surna	acidify
surra	buzz
suverän	sovereign
svag	faint
sval	cool
svala	swallow
svamp	fungus
svan	swan
svans	tail
svar	answer
svara	answer
svart	black
svavel	brimstone
svek	swindle
svensk	Swedish
svenska	Swedish
svett	perspiration
svettas	sweat
svimma	faint
svin	hog
svinga	brandish
svägerska	sister‐in‐law
svält	hunger
sväng	bend
svära	blaspheme
svärd	sword
svärdotter	daughter‐in‐law
svärfader	father‐in‐law
svärfar	father‐in‐law
svärföräldrar	parents‐in‐law
svärm	swarm
svärmor	mother‐in‐law
svärson	son‐in‐law
sväva	float
svåger	brother‐in‐law
svår	difficult
svårighet	difficulty
sy	sew
syd	south
sydlig	south
symbol	symbol
symfoni	symphony
symmetrisk	symmetric
sympati	sympathy
sympatisk	sympathetic
synagoga	synagogue
synas	appear
synbarligen	evident
synd	sin
synda	sin
syndabekännelse	confession
syndig	sinful
synlig	visible
synnerlig	extraordinary
synpunkt	viewpoint
syra	acid
syre	oxygen
syren	lilac
syrsa	cricket
syskon	brothers and sisters
system	system
systematisk	systematic
syster	sister
systerdotter	niece
systerson	nephew
säd	grain
säga	say
säga adjö	say goodbye
säga adjö till	say goodbye
sägen	legend
sägn	legend
säker	certain
säkerhetsnål	safety‐pin
säl	seal
sälja	dispose of
sällsam	rare
sällspord	rare
sällsynt	rare
sämre	worse
sämst	worst
sända	send
sändebud	ambassador
säng	bed
sängkammare	bedroom
sängplats	sleeping‐accomodation
särskild	apart
säsong	season
säteri	estate
sätt	manner
sätta	lay down
söder	south
södra	south
söka	run for election
sökande	candidate
sömn	sleep
söndag	Sunday
sörja	mud
söt	gentle
sötvatten	fresh water
så	barrel
sådan	such
såg	saw
såga	saw
såll	sieve
sålla	sift
sålunda	so
sång	singing
sångare	singer
sångerska	singer
sångmö	muse
såpa	soap
sår	injury
såra	hurt
sås	gravy
såt	close
såvida	if
såvitt	if
ta	get
tabell	index
tack	gratitude
tacka	thank
tacka för	acknowledge
tacka ja till	accept
tacka nej till	reject
tacksam	thankful
tack ska du ha	thank you
tack så mycket	thank you very much
tack tack	thank you
taga	get
tagg	thorn
tak	ceiling
tala	speak
talang	aptitude
tall	pine
tallricksslickare	cadger
tallrik	plate
talltrast	thrush
tallös	countless
tam	tame
tand	tooth
tandborste	tooth‐brush
tandkräm	tooth‐paste
tandkött	gum
tandläkare	dentist
tandpetare	toothpick
tandvärk	toothache
tanke	thought
tant	aunt
tapet	tapestry
tapetsera	paper
tapetserare	paperer
tapper	brave
tarm	intestine
tass	claw
tattare	gypsy
tavla	painting
taxa	tax
taxera	tax
ta hänsyn till	pay attention to
te	tea
teater	theatre
teaterpjäs	play
tecken	character
teckna	design
teckning	design
tegelsten	brick
tekanna	tea‐pot
teknik	technics
teknisk	technical
telefon	telephone
telefonera	telephone
telefonhytt	call box
telegraf	telegraph
telegrafera	telegraph
telegram	telegram
television	television
telning	child
tema	theme
tempel	temple
temperatur	temperature
tempo	speed
tenn	tin
tenor	tenor
teori	theory
term	term
termometer	thermometer
terrass	terrace
terrorism	terrorism
terräng	ground
testamente	testament
text	lyric
tid	time
tidig	early
tidningsman	journalist
tidskrift	periodical
tidtabell	schedule
tie	ten
tiga	be quiet
tiger	tiger
tigga	beg
tiggare	beggar
tiggeri	begging
tiggerska	beggar‐woman
tilja	floor
till	at
tillaga	prepare
tillbedja	adore
tillfälle	chance
tillfällighet	accidence
tillfälligtvis	by accident
tillförlitlig	reliable
tillhopa	together
tillit	confidence
tillkommande	future
tillkomst	arrival
tillkännagiva	acquaint
tillkännagivande	advice
tillnamn	surname
tillreda	prepare
tillreds	finished
tills	until
tillsammans	together
tillvaro	existence
till exempel	for example
till salu	for sale
till uthyrning	for rent
timme	hour
tinning	temple
tio	ten
tionde	tenth
tipp	hint
tippa	bet
tisdag	Tuesday
tissla	whisper
titel	degree
titta	see
tjock	bold
tjocka	fog
tjockben	calf
tjockhet	thickness
tjocklek	thickness
tjugo	twenty
tjugoen	twenty‐one
tjugoett	twenty‐one
tjugonde	twentieth
tjugu	twenty
tjur	bull
tjuv	thief
tjuvgömmare	fence
tjuvnad	abstraction
tjänare	boy
tjänarinna	maid
tjänst	service
tjänstflicka	maid
tjänstsökande	candidate
tjära	tar
toalett	toilet
toalettpapper	toilet‐paper
tobak	tobacco
toffel	slipper
toga	toga
tok	crazy
tokig	crazy
tolerant	tolerant
tolfte	twelfth
tolk	interpreter
tolka	interpret
tolv	twelve
tom	empty
tomat	tomato
tomhet	emptiness
ton	tone
tona	sound
tonsättare	composer
tordön	thunder
torg	plaza
torka	dryness
torn	thorn
torr	dry
torsdag	Thursday
torsk	cod
tortera	agonize
tortyr	torture
total	overall
tradition	tradition
trafik	traffic
trafikant	passenger
trakt	region
traktera	deal with
trall	melody
trampa	pedal
transpirera	sweat
transport	transport
transportera	transport
trappa	staircase
trassel	chaos
trast	thrush
tratt	funnel
tre	three
tredje	third
trefaldig	triple
trehörnig	triangular
trehörning	triangle
tretti	thirty
trettio	thirty
tretton	thirteen
trettondag	Epiphany
trettonde	thirteenth
trevlig	agreeable
triangel	triangle
triangulär	triangular
tribun	rostrum
tribut	tax
triumf	triumph
triumfera	triumph
trivial	commonplace
tro	account
troende	religious
trolig	plausible
troligtvis	probably
trolla	bewitch
trolleri	enchantment
tron	throne
tropisk	tropical
trots	despite
trottoar	pavement
trovärdig	plausible
tro på	believe in
trumpet	trumpet
tryck	pressure
trycka	press
tryckpress	press
trygg	certain
trä‐	wooden
trä	timber
träd	tree
trädgård	garden
trädgårdsmästare	gardener
träffas	meet
träl	serf
träla	work hard
träsk	marsh
trög	slow
trögdjur	sloth
tröskel	sill
tröst	consolation
trösta	comfort
tröstlös	desolate
trött	tired
tröttna	get tired
tråd	thread
trång	narrow
tsar	czar
tu	two
tuberkulos	tuberculosis
tuggummi	chewing‐gum
tuktig	chaste
tull	custom‐house
tulpan	tulip
tum	inch
tumme	thumb
tumult	agitation
tung	burdensome
tunga	tongue
tungomål	language
tunn	gaunt
tunna	barrel
tunnel	tunnel
tunnelbana	subway
tupp	cock
tur	luck
turist	tourist
turk	Turk
tusch	nasturtium
tusen	thousand
tusenfoting	centipede
tveka	hesitate
tvekan	hesitation
tvenne	two
tvetydig	ambiguous
tvilling	twins
tvillingar	twins
tvinga	compel
tvist	quarrel
tvista	quarrel
tvivelaktig	doubtful
tvivla	doubt
tvätta	wash
tvätterska	laundress
två	two
tvål	soap
två hundra	two hundred
tycka	account
tyckas	appear
tycka illa om	dislike
tycka om	appreciate
tycka synd om	have compassion on
tycke	opinion
tydlig	clear
tyg	agent
typ	type
typisk	typical
tyrann	tyrant
tyrannisera	tyrannize
tysk	German
tyska	German
tyst	silent
tyvärr	alas
täcka	cover
tändsticka	match
tändstift	plug
tänka	think
tärning	die
tätting	sparrow
tävlan	competition
tävling	competition
töcken	fog
töcknig	fuzzy
töras	be bold
törhända	maybe
törn	push
törne	thorn
törst	thirst
törstig	thirsty
tös	girl
töväder	melting
tå	toe
tåga	fiber
tåla	endure
tålamod	patience
tålig	patient
tålmodig	patient
tår	tear
tårta	pie
uggla	owl
ull	wool
ulv	wolf
umgås med	associate with
undanflykt	pretext
under	miracle
underbar	miraculous
underbyxor	drawers
underhålla	alimony
underjordisk	underground
underofficer	noncom
underskrift	signature
underskriva	sign
undersöka	examine
undersökning	investigation
underteckna	sign
undervisa	teach
undervisning	instruction
underårig	under age
undfly	avoid
undflykt	escape
undfå	get
undkomma	escape
undra	marvel
undran	astonishment
undseende	respect
undskylla sig	apologize
ung	young
ungdom	youth
ungdomlig	young
unge	child
ungefär	about
ungefärlig	about
ungrare	Hungarian
uniform	uniform
unik	unique
union	union
universal	general
universell	general
universitet	university
upp	above
uppacka	unpack
uppbjuda	invite
uppe	above
uppenbar	evident
uppfattning	opinion
uppfinning	invention
uppfostra	breed
uppfostran	education
uppfylla	fill
uppförande	behavior
uppföra sig	behave
uppgiven	exhausted
upphisa	lever
upphitta	find
upphov	lineage
upphäva	lever
upphöja	lever
uppkomst	lineage
uppkäftig	impertinent
uppleva	go through
upprepa	repeat
uppskatta	appraise
uppskov	adjournment
upptill	above
upptäcka	discover
upptäckt	discovery
upptåg	gag
uppvisa	indicate
uppväxtår	youth
uppåt	above
ur	watch
urbild	prototype
urmakare	watchmaker
urmodig	old‐fashioned
urna	jug
ursinnig	furious
urskog	primeval forest
urskulda	excuse
ursprung	lineage
ursprunglig	coming
ursäkta	excuse me
ursäkte sig	apologize
urval	chrestomathy
ut	from
utan	without
utav	from
utblotta	rob
utbörding	foreigner
utdela	distribute
utdelning	distribution
ute	abroad
uteglömma	forget
utgift	edition
utgivare	publisher
utgång	exit
uthyra	let
utland	foreign country
utlägga	account for
utländsk	alien
utlänning	foreigner
utlåtande	account
utnöta	use up
utom	apart from
utomlands	abroad
utomordentlig	extraordinary
utpeka	indicate
utplåna	exterminate
utrikes	abroad
utrymme	room
uträkna	calculate
utsikt	view
utskicka	broadcast
utställa	exhibit
utställning	exhibition
uttryck	expression
uttrycka	express
utvandra	emigrate
utöver	apart from
uv	eagle owl
vaccin	vaccine
vaccinera	vaccinate
vacker	beautiful
vad	calf
vada	wade
vadd	cotton‐wool
vakna	wake
vakta	guard
vaktare	guard
vaktmästare	waiter
val	whale
valakt	choice
valfisk	whale
vall	dike
vallmo	poppy
vallon	Walloon
valnöt	walnut
valör	value
vampyr	vampire
vana	custom
vanilj	vanilla
vanlig	accustomed
vansinne	craziness
vansinnig	cr